6,1,0 6,1,0 6,1,0 6,1,0 6,1,0 6,1,0 6,1,0 6,1,0 6,1,0 6,1,0 6,1,0 6,1,0 6,1,0 6,1,0 6,1,0 6,1,0 6,1,0 6,1,0 6,1,0 6,1,0 6,1,0 6,1,0 6,1,0 6,1,0 6,1,0 6,1,0 6,1,0 6,1,0 6,1,0 6,1,0 6,1,0 6,1,0 6,1,0 6,1,0 6,1,0 6,1,0 6,1,0
6,1,0 6,1,0 6,1,0 6,1,0 6,1,0 6,1,0 6,1,0 6,1,0 6,1,0 6,1,0 6,1,0 6,1,0 6,1,0 6,1,0 6,1,0 6,1,0 6,1,0 6,1,0 6,1,0 6,1,0 6,1,0 6,1,0 6,1,0 6,1,0 6,1,0 6,1,0 6,1,0 6,1,0 6,1,0 6,1,0 6,1,0 6,1,0 6,1,0 6,1,0 6,1,0 6,1,0 6,1,0
6,1,0 6,1,0 6,1,0 6,1,0 6,1,0 6,1,0 6,1,0 6,1,0 6,1,0 6,1,0 6,1,0 6,1,0 6,1,0 6,1,0 6,1,0 6,1,0 6,1,0 6,1,0 6,1,0 6,1,0 6,1,0 6,1,0 6,1,0 6,1,0 6,1,0 6,1,0 6,1,0 6,1,0 6,1,0 6,1,0 6,1,0 6,1,0 6,1,0 6,1,0 6,1,0 6,1,0 6,1,0
6,1,0 6,1,0 6,1,0 6,1,0 6,1,0 6,1,0 6,1,0 6,1,0 6,1,0 6,1,0 6,1,0 6,1,0 6,1,0 6,1,0 6,1,0 6,1,0 6,1,0 6,1,0 6,1,0 6,1,0 6,1,0 6,1,0 6,1,0 6,1,0 6,1,0 6,1,0 6,1,0 6,1,0 6,1,0 6,1,0 6,1,0 6,1,0 6,1,0 6,1,0 6,1,0 6,1,0 6,1,0
6,1,0 6,1,0 6,1,0 6,1,0 6,1,0 6,1,0 6,1,0 6,1,0 6,1,0 6,1,0 6,1,0 6,1,0 6,1,0 6,1,0 6,1,0 6,1,0 6,1,0 6,1,0 6,1,0 6,1,0 6,1,0 6,1,0 6,1,0 6,1,0 6,1,0 6,1,0 6,1,0 6,1,0 6,1,0 6,1,0 6,1,0 6,1,0 6,1,0 6,1,0 6,1,0 6,1,0 6,1,0
6,1,0 6,1,0 6,1,0 6,1,0 6,1,0 6,1,0 6,1,0 6,1,0 6,1,0 6,1,0 6,1,0 6,1,0 6,1,0 6,1,0 6,1,0 6,1,0 6,1,0 6,1,0 6,1,0 6,1,0 6,1,0 6,1,0 6,1,0 6,1,0 6,1,0 6,1,0 6,1,0 6,1,0 6,1,0 6,1,0 6,1,0 6,1,0 6,1,0 6,1,0 6,1,0 6,1,0 6,1,0
6,1,0 6,1,0 6,1,0 6,1,0 6,1,0 6,1,0 6,1,0 6,1,0 6,1,0 6,1,0 6,1,0 6,1,0 6,1,0 6,1,0 6,1,0 6,1,0 6,1,0 6,1,0 6,1,0 6,1,0 6,1,0 6,1,0 6,1,0 6,1,0 6,1,0 6,1,0 6,1,0 6,1,0 6,1,0 6,1,0 6,1,0 6,1,0 6,1,0 6,1,0 6,1,0 6,1,0 6,1,0
6,1,0 6,1,0 6,1,0 6,1,0 6,1,0 6,1,0 6,1,0 0,4,4 1,4,4 1,4,4 1,4,4 1,4,4 1,4,4 1,4,4 1,4,4 1,4,4 1,4,4 1,4,4 1,4,4 1,4,4 1,4,4 1,4,4 1,4,4 1,4,4 1,4,4 1,4,4 1,4,4 1,4,4 1,4,4 1,4,4 1,4,2 1,4,4 1,4,4 1,4,4 1,4,4 1,4,0 1,4,0
6,1,0 6,1,0 6,1,0 6,1,0 6,1,0 6,1,0 6,1,0 0,5,4 0,0,4 0,0,4 0,0,4 0,0,4 0,0,4 0,0,4 0,0,4 0,0,4 0,0,4 0,0,4 0,0,4 0,0,4 0,0,4 0,0,4 0,0,4 0,0,4 0,0,4 0,0,4 0,0,4 0,0,4 0,0,4 0,0,4 0,0,2 0,0,4 0,0,4 0,0,4 0,0,4 0,0,0 0,0,0
6,1,0 6,1,0 6,1,0 6,1,0 6,1,0 6,1,0 6,1,0 0,5,4 0,0,4 0,0,4 0,0,4 0,0,4 0,0,4 0,0,4 0,0,4 0,0,4 0,0,4 0,0,4 0,0,4 0,0,4 0,0,4 0,0,4 0,0,4 0,0,4 0,0,4 0,0,4 0,0,4 0,0,4 0,0,4 0,0,4 0,0,2 0,0,4 0,0,4 0,0,4 0,0,4 0,0,0 0,0,0
6,1,0 6,1,0 6,1,0 6,1,0 6,1,0 6,1,0 6,1,0 0,5,4 0,0,4 0,0,4 0,0,4 0,0,4 0,0,4 0,0,4 0,0,4 0,0,4 0,0,4 0,0,4 0,0,4 0,0,4 0,0,4 0,0,4 0,0,4 0,0,4 0,0,4 0,0,4 0,0,4 0,0,4 0,0,4 0,0,4 0,0,2 0,0,4 0,0,4 0,0,4 0,0,4 0,0,0 0,0,0
6,1,0 6,1,0 6,1,0 6,1,0 6,1,0 6,1,0 6,1,0 0,5,4 0,0,4 0,0,4 0,0,4 0,0,4 0,0,4 0,0,4 0,0,4 0,0,4 0,0,4 0,0,4 0,0,4 0,0,4 0,0,4 0,0,4 0,0,4 0,0,4 0,0,4 0,0,4 0,0,4 0,0,4 0,0,4 0,0,4 0,0,2 0,0,4 0,0,4 0,0,4 0,0,4 0,0,0 0,0,0
6,1,0 6,1,0 6,1,0 6,1,0 6,1,0 6,1,0 6,1,0 0,5,4 0,0,4 0,0,4 0,0,4 0,0,4 0,0,4 0,0,4 0,0,4 0,0,4 0,0,4 0,0,4 0,0,4 0,0,4 0,0,4 0,0,4 0,0,4 0,0,4 0,0,4 0,0,4 0,0,4 0,0,4 0,0,4 0,0,4 0,0,2 0,0,4 0,0,4 0,0,4 0,0,4 0,0,0 0,0,0
6,1,0 6,1,0 6,1,0 6,1,0 6,1,0 6,1,0 6,1,0 0,5,4 0,0,4 0,0,4 0,0,4 0,0,4 0,0,4 0,0,4 0,0,4 0,0,4 0,0,4 0,0,4 0,0,4 0,0,4 0,0,4 0,0,4 0,0,4 0,0,4 0,0,4 0,0,4 0,0,4 0,0,4 0,0,4 0,0,4 0,0,2 0,0,4 0,0,4 0,0,4 0,0,4 0,0,0 0,0,0
6,1,0 6,1,0 6,1,0 6,1,0 6,1,0 6,1,0 6,1,0 0,5,4 0,0,4 0,0,4 0,0,4 0,0,4 0,0,4 0,0,4 0,0,4 0,0,4 0,0,4 0,0,4 0,0,4 0,0,4 0,0,4 0,0,4 0,0,4 0,0,4 0,0,4 0,0,4 0,0,4 0,0,4 0,0,4 0,0,4 0,0,2 0,0,4 0,0,4 0,0,4 0,0,4 0,0,0 0,0,0
6,1,0 6,1,0 6,1,0 6,1,0 6,1,0 6,1,0 6,1,0 0,5,4 0,0,4 0,0,4 0,0,4 0,0,4 0,0,4 0,0,4 0,0,4 0,0,4 0,0,4 0,0,4 0,0,4 0,0,4 0,0,4 0,0,4 0,0,4 0,0,4 0,0,4 0,0,4 0,0,4 0,0,4 0,0,4 0,0,4 0,0,2 0,0,4 0,0,4 0,0,4 0,0,4 0,0,0 0,0,0
6,1,0 6,1,0 6,1,0 6,1,0 6,1,0 6,1,0 6,1,0 0,5,4 0,0,4 0,0,4 0,0,4 0,0,4 0,0,4 0,0,4 0,0,4 0,0,4 0,0,4 0,0,4 0,0,4 0,0,4 0,0,4 0,0,4 0,0,4 0,0,4 0,0,4 0,0,4 0,0,4 0,0,4 0,0,4 0,0,4 0,0,2 0,0,4 0,0,4 0,0,4 0,0,4 0,0,0 0,0,0
6,1,0 6,1,0 6,1,0 6,1,0 6,1,0 6,1,0 6,1,0 0,5,4 0,0,4 0,0,4 0,0,4 0,0,4 0,0,4 0,0,4 0,0,4 0,0,4 0,0,4 0,0,4 0,0,4 0,0,4 0,0,4 0,0,4 0,0,4 0,0,4 0,0,4 0,0,4 0,0,4 0,0,4 0,0,4 0,0,4 0,0,2 0,0,4 0,0,4 0,0,4 0,0,4 0,0,0 0,0,0
6,1,0 6,1,0 6,1,0 6,1,0 6,1,0 6,1,0 6,1,0 0,5,4 0,0,4 0,0,4 0,0,4 0,0,4 0,0,4 0,0,4 0,0,4 0,0,4 0,0,4 0,0,4 0,0,4 0,0,4 0,0,4 0,0,4 0,0,4 0,0,4 0,0,4 0,0,4 0,0,4 0,0,4 0,0,4 0,0,4 0,0,2 0,0,4 0,0,4 0,0,4 0,0,4 0,0,0 0,0,0
6,1,0 6,1,0 6,1,0 6,1,0 6,1,0 6,1,0 6,1,0 0,5,4 0,0,4 0,0,4 0,0,4 0,0,4 0,0,4 0,0,4 0,0,4 0,0,4 0,0,4 0,0,4 0,0,4 0,0,4 0,0,4 0,0,4 0,0,4 0,0,4 0,0,4 0,0,4 0,0,4 0,0,4 0,0,4 0,0,4 0,0,2 0,0,4 0,0,4 0,0,4 0,0,4 0,0,0 0,0,0
6,1,0 6,1,0 6,1,0 6,1,0 6,1,0 6,1,0 6,1,0 0,5,4 0,0,4 0,0,4 0,0,4 0,0,4 0,0,4 0,0,4 0,0,4 0,0,4 0,0,4 0,0,4 0,0,4 0,0,4 0,0,4 0,0,4 0,0,4 0,0,4 0,0,4 0,0,4 0,0,4 0,0,4 0,0,4 0,0,4 0,0,2 0,0,4 0,0,4 0,0,4 0,0,4 0,0,0 0,0,0
6,1,0 6,1,0 6,1,0 6,1,0 6,1,0 6,1,0 6,1,0 0,5,4 0,0,4 0,0,4 0,0,4 0,0,4 0,0,4 0,0,4 0,0,4 0,0,4 0,0,4 0,0,4 0,0,4 0,0,4 0,0,4 0,0,4 0,0,4 0,0,4 0,0,4 0,0,4 0,0,4 0,0,4 0,0,4 0,0,4 0,0,2 0,0,4 0,0,4 0,0,4 0,0,4 0,0,0 0,0,0
6,1,0 6,1,0 6,1,0 6,1,0 6,1,0 6,1,0 6,1,0 0,5,4 0,0,4 0,0,4 0,0,4 0,0,4 0,0,4 0,0,4 0,0,4 0,0,4 0,0,4 0,0,4 0,0,4 0,0,4 0,0,4 0,0,4 0,0,4 0,0,4 0,0,4 0,0,4 0,0,4 0,0,4 0,0,4 0,0,4 0,0,2 0,0,4 0,0,4 0,0,4 0,0,4 0,0,0 0,0,0
6,1,0 6,1,0 6,1,0 6,1,0 6,1,0 6,1,0 6,1,0 0,5,4 0,0,4 0,0,4 0,0,4 0,0,4 0,0,4 0,0,4 0,0,4 0,0,4 0,0,4 0,0,4 0,0,4 0,1,4 1,1,4 1,1,4 1,1,4 1,1,4 1,1,4 1,1,4 1,1,4 1,1,4 1,1,4 1,1,4 1,1,2 1,1,4 1,1,4 1,1,4 1,1,4 1,1,0 1,1,0
6,1,0 6,1,0 6,1,0 6,1,0 6,1,0 6,1,0 6,1,0 0,5,4 0,0,4 0,0,4 0,0,4 0,0,4 0,0,4 0,0,4 0,0,4 0,0,4 0,0,4 0,0,4 0,0,4 0,2,4 3,1,4 4,1,4 4,1,4 4,1,4 4,1,4 4,1,4 4,1,4 4,1,4 4,1,4 4,1,4 4,1,2 4,1,0 4,1,0 4,1,0 4,1,0 4,1,0 4,1,0
6,1,0 6,1,0 6,1,0 6,1,0 6,1,0 6,1,0 6,1,0 0,5,4 0,0,4 0,0,4 0,0,4 0,0,4 0,0,4 0,0,4 0,0,4 0,0,4 0,0,4 0,0,4 0,0,4 0,2,4 3,2,4 6,2,0 6,2,0 6,2,0 6,2,0 6,2,0 6,2,0 6,2,0 6,2,0 6,2,0 6,2,0 6,2,0 6,2,0 6,2,0 6,2,0 6,2,0 6,2,0
6,1,0 6,1,0 6,1,0 6,1,0 6,1,0 6,1,0 6,1,0 0,5,4 0,0,4 0,0,4 0,0,4 0,0,4 0,0,4 0,0,4 0,0,4 0,0,4 0,0,4 0,0,4 0,0,4 0,2,4 3,2,4 6,2,0 6,2,0 6,2,0 6,2,0 6,2,0 6,2,0 6,2,0 6,2,0 6,2,0 6,2,0 6,2,0 6,2,0 6,2,0 6,2,0 6,2,0 6,2,0
6,1,0 6,1,0 6,1,0 6,1,0 6,1,0 6,1,0 6,1,0 0,5,4 0,0,4 0,0,4 0,0,4 0,0,4 0,0,4 0,0,4 0,0,4 0,0,4 0,0,4 0,0,4 0,0,4 0,2,4 3,2,4 6,2,0 6,2,0 6,2,0 6,2,0 6,2,0 6,2,0 6,2,0 6,2,0 6,2,0 6,2,0 6,2,0 6,2,0 6,2,0 6,2,0 6,2,0 6,2,0
6,1,0 6,1,0 6,1,0 6,1,0 6,1,0 6,1,0 6,1,0 0,5,4 0,0,4 0,0,4 0,0,4 0,0,4 0,0,4 0,0,4 0,0,4 0,0,4 0,0,4 0,0,4 0,0,4 0,2,4 3,2,4 6,2,0 6,2,0 6,2,0 6,2,0 6,2,0 6,2,0 6,2,0 6,2,0 6,2,0 6,2,0 6,2,0 6,2,0 6,2,0 6,2,0 6,2,0 6,2,0
6,1,0 6,1,0 6,1,0 6,1,0 6,1,0 6,1,0 6,1,0 0,5,4 0,0,4 0,0,4 0,0,4 0,0,4 0,0,4 0,0,4 0,0,4 0,0,4 0,0,4 0,0,4 0,0,4 0,2,4 3,2,4 6,2,0 6,2,0 6,2,0 6,2,0 6,2,0 6,2,0 6,2,0 6,2,0 6,2,0 6,2,0 6,2,0 6,2,0 6,2,0 6,2,0 6,2,0 6,2,0
6,1,0 6,1,0 6,1,0 6,1,0 6,1,0 6,1,0 6,1,0 0,5,3 0,0,3 0,0,3 0,0,3 0,0,3 0,0,3 0,0,3 0,0,3 0,0,3 0,0,3 0,0,3 0,0,3 0,2,3 3,2,3 6,2,0 6,2,0 6,2,0 6,2,0 6,2,0 6,2,0 6,2,0 6,2,0 6,2,0 6,2,0 6,2,0 6,2,0 6,2,0 6,2,0 6,2,0 6,2,0
6,1,0 6,1,0 6,1,0 6,1,0 6,1,0 6,1,0 6,1,0 0,5,4 0,0,4 0,0,4 0,0,4 0,0,4 0,0,4 0,0,4 0,0,4 0,0,4 0,0,4 0,0,4 0,0,4 0,2,4 3,2,4 6,2,0 6,2,0 6,2,0 6,2,0 6,2,0 6,2,0 6,2,0 6,2,0 6,2,0 6,2,0 6,2,0 6,2,0 6,2,0 6,2,0 6,2,0 6,2,0
6,1,0 6,1,0 6,1,0 6,1,0 6,1,0 6,1,0 6,1,0 0,5,4 0,0,4 0,0,4 0,0,4 0,0,4 0,0,4 0,0,4 0,0,4 0,0,4 0,0,4 0,0,4 0,0,4 0,2,4 3,2,4 6,2,0 6,2,0 6,2,0 6,2,0 6,2,0 6,2,0 6,2,0 6,2,0 6,2,0 6,2,0 6,2,0 6,2,0 6,2,0 6,2,0 6,2,0 6,2,0
6,1,0 6,1,0 6,1,0 6,1,0 6,1,0 6,1,0 6,1,0 0,5,4 0,0,4 0,0,4 0,0,4 0,0,4 0,0,4 0,0,4 0,0,4 0,0,4 0,0,4 0,0,4 0,0,4 0,2,4 3,2,4 6,2,0 6,2,0 6,2,0 6,2,0 6,2,0 6,2,0 6,2,0 6,2,0 6,2,0 6,2,0 6,2,0 6,2,0 6,2,0 6,2,0 6,2,0 6,2,0
6,1,0 6,1,0 6,1,0 6,1,0 6,1,0 6,1,0 6,1,0 0,5,4 0,0,4 0,0,4 0,0,4 0,0,4 0,0,4 0,0,4 0,0,4 0,0,4 0,0,4 0,0,4 0,0,4 0,2,4 3,2,4 6,2,0 6,2,0 6,2,0 6,2,0 6,2,0 6,2,0 6,2,0 6,2,0 6,2,0 6,2,0 6,2,0 6,2,0 6,2,0 6,2,0 6,2,0 6,2,0
6,1,0 6,1,0 6,1,0 6,1,0 6,1,0 6,1,0 6,1,0 0,5,4 0,0,4 0,0,4 0,0,4 0,0,4 0,0,4 0,0,4 0,0,4 0,0,4 0,0,4 0,0,4 0,0,4 0,2,4 3,2,4 6,2,0 6,2,0 6,2,0 6,2,0 6,2,0 6,2,0 6,2,0 6,2,0 6,2,0 6,2,0 6,2,0 6,2,0 6,2,0 6,2,0 6,2,0 6,2,0
6,1,0 6,1,0 6,1,0 6,1,0 6,1,0 6,1,0 6,1,0 0,5,4 0,0,4 0,0,4 0,0,4 0,0,4 0,0,4 0,0,4 0,0,4 0,0,4 0,0,4 0,0,4 0,0,4 0,2,4 3,2,4 6,2,0 6,2,0 6,2,0 6,2,0 6,2,0 6,2,0 6,2,0 6,2,0 6,2,0 6,2,0 6,2,0 6,2,0 6,2,0 6,2,0 6,2,0 6,2,0