06,01,00 06,01,00 06,01,00 06,01,00 06,01,00 06,01,00 06,01,00 06,01,00 06,01,00 06,01,00 06,01,00 06,01,00 06,01,00 06,01,00 06,01,00 06,01,00 06,01,00 06,01,00 06,01,00 06,01,00 06,01,00 06,01,00 06,01,00 06,01,00 06,01,00 06,01,00 06,01,00 06,01,00 06,01,00 06,01,00 06,01,00 06,01,00 06,01,00 06,01,00 06,01,00 06,01,00 06,01,00
06,01,00 06,01,00 06,01,00 06,01,00 06,01,00 06,01,00 06,01,00 06,01,00 06,01,00 06,01,00 06,01,00 06,01,00 06,01,00 06,01,00 06,01,00 06,01,00 06,01,00 06,01,00 06,01,00 06,01,00 06,01,00 06,01,00 06,01,00 06,01,00 06,01,00 06,01,00 06,01,00 06,01,00 06,01,00 06,01,00 06,01,00 06,01,00 06,01,00 06,01,00 06,01,00 06,01,00 06,01,00
06,01,00 06,01,00 06,01,00 06,01,00 06,01,00 06,01,00 06,01,00 06,01,00 06,01,00 06,01,00 06,01,00 06,01,00 06,01,00 06,01,00 06,01,00 06,01,00 06,01,00 06,01,00 06,01,00 06,01,00 06,01,00 06,01,00 06,01,00 06,01,00 06,01,00 06,01,00 06,01,00 06,01,00 06,01,00 06,01,00 06,01,00 06,01,00 06,01,00 06,01,00 06,01,00 06,01,00 06,01,00
06,01,00 06,01,00 06,01,00 06,01,00 06,01,00 06,01,00 06,01,00 06,01,00 06,01,00 06,01,00 06,01,00 06,01,00 06,01,00 06,01,00 06,01,00 06,01,00 06,01,00 06,01,00 06,01,00 06,01,00 06,01,00 06,01,00 06,01,00 06,01,00 06,01,00 06,01,00 06,01,00 06,01,00 06,01,00 06,01,00 06,01,00 06,01,00 06,01,00 06,01,00 06,01,00 06,01,00 06,01,00
06,01,00 06,01,00 06,01,00 06,01,00 06,01,00 06,01,00 06,01,00 06,01,00 06,01,00 06,01,00 06,01,00 06,01,00 06,01,00 06,01,00 06,01,00 06,01,00 06,01,00 06,01,00 06,01,00 06,01,00 06,01,00 06,01,00 06,01,00 06,01,00 06,01,00 06,01,00 06,01,00 06,01,00 06,01,00 06,01,00 06,01,00 06,01,00 06,01,00 06,01,00 06,01,00 06,01,00 06,01,00
06,01,00 06,01,00 06,01,00 06,01,00 06,01,00 06,01,00 06,01,00 06,01,00 06,01,00 06,01,00 06,01,00 06,01,00 06,01,00 06,01,00 06,01,00 06,01,00 06,01,00 06,01,00 06,01,00 06,01,00 06,01,00 06,01,00 06,01,00 06,01,00 06,01,00 06,01,00 06,01,00 06,01,00 06,01,00 06,01,00 06,01,00 06,01,00 06,01,00 06,01,00 06,01,00 06,01,00 06,01,00
06,01,00 06,01,00 06,01,00 06,01,00 06,01,00 06,01,00 06,01,00 06,01,00 06,01,00 06,01,00 06,01,00 06,01,00 06,01,00 06,01,00 06,01,00 06,01,00 06,01,00 06,01,00 06,01,00 06,01,00 06,01,00 06,01,00 06,01,00 06,01,00 06,01,00 06,01,00 06,01,00 06,01,00 06,01,00 06,01,00 06,01,00 06,01,00 06,01,00 06,01,00 06,01,00 06,01,00 06,01,00
06,01,00 06,01,00 06,01,00 06,01,00 06,01,00 06,01,00 06,01,00 00,04,00 01,04,00 01,04,00 01,04,00 01,04,00 01,04,00 01,04,00 01,04,00 01,04,00 01,04,00 01,04,00 01,04,00 01,04,00 01,04,00 01,04,00 01,04,00 01,04,00 01,04,00 01,04,00 01,04,00 01,04,00 01,04,00 01,04,00 01,04,00 01,04,04 01,04,04 01,04,04 01,04,04 01,04,04 01,04,04
06,01,00 06,01,00 06,01,00 06,01,00 06,01,00 06,01,00 06,01,00 00,05,00 07,00,05 07,00,05 09,02,00 05,15,00 06,15,00 07,15,00 08,15,00 09,15,00 00,00,04 10,15,00 11,15,00 12,15,00 13,15,00 14,15,00 00,00,04 05,15,00 06,15,00 07,15,00 08,15,00 09,15,00 00,00,04 03,00,00 00,00,02 00,00,04 00,00,04 00,00,04 00,00,04 00,00,04 00,00,04
06,01,00 06,01,00 06,01,00 06,01,00 06,01,00 06,01,00 06,01,00 00,05,00 07,00,05 07,00,05 09,02,00 05,16,00 06,16,00 07,16,00 08,16,00 09,16,00 00,00,04 10,16,00 11,16,00 12,16,00 13,16,00 14,16,00 00,00,04 05,16,00 06,16,00 07,16,00 08,16,00 09,16,00 00,00,04 03,00,00 00,00,02 00,00,04 00,00,04 00,00,04 00,00,04 00,00,04 00,00,04
06,01,00 06,01,00 06,01,00 06,01,00 06,01,00 06,01,00 06,01,00 00,05,00 07,00,05 07,00,05 09,02,00 05,17,00 06,17,00 07,17,00 08,17,00 09,17,00 00,00,04 10,17,00 11,17,00 12,17,00 13,17,00 14,17,00 00,00,04 05,17,00 06,17,00 07,17,00 08,17,00 09,17,00 00,00,04 03,00,00 00,00,02 00,00,04 00,00,04 00,00,04 00,00,04 00,00,04 00,00,04
06,01,00 06,01,00 06,01,00 06,01,00 06,01,00 06,01,00 06,01,00 00,05,00 07,00,05 07,00,05 09,02,00 05,18,00 06,18,00 07,18,00 08,18,00 09,18,00 00,00,04 10,18,00 11,18,00 12,18,00 13,18,00 14,18,00 00,00,04 05,18,00 06,18,00 07,18,00 08,18,00 09,18,00 00,00,04 03,00,00 00,00,02 00,00,04 00,00,04 00,00,04 00,00,04 00,00,04 00,00,04
06,01,00 06,01,00 06,01,00 06,01,00 06,01,00 06,01,00 06,01,00 00,05,00 07,00,05 07,00,05 09,02,00 03,04,04 04,04,04 04,04,04 04,04,04 04,04,04 04,04,04 04,04,04 04,04,04 04,04,04 04,04,04 04,04,04 04,04,04 04,04,04 04,04,04 04,04,04 04,04,04 04,04,04 04,04,04 04,04,04 00,00,02 00,00,04 00,00,04 00,00,04 00,00,04 00,00,04 00,00,04
06,01,00 06,01,00 06,01,00 06,01,00 06,01,00 06,01,00 06,01,00 00,05,00 00,00,04 10,02,00 09,03,00 03,05,04 04,05,04 04,05,04 04,05,04 04,05,04 04,05,04 04,05,04 04,05,04 04,05,04 04,05,04 04,05,04 04,05,04 04,05,04 04,05,04 04,05,04 04,05,04 04,05,04 06,04,04 04,05,04 00,00,02 00,00,04 00,00,04 00,00,04 00,00,04 00,00,04 00,00,04
06,01,00 06,01,00 06,01,00 06,01,00 06,01,00 06,01,00 06,01,00 00,05,00 00,00,04 00,00,04 00,00,04 03,06,04 04,00,00 05,00,00 05,00,00 05,00,00 05,00,00 05,00,00 05,00,00 05,00,00 05,00,00 05,00,00 05,00,00 05,00,00 05,00,00 05,00,00 05,00,00 06,00,00 05,06,04 03,00,00 00,00,02 00,00,04 00,00,04 00,00,04 00,00,04 00,00,04 00,00,04
06,01,00 06,01,00 06,01,00 06,01,00 06,01,00 06,01,00 06,01,00 00,05,00 00,00,04 00,00,04 00,00,04 03,06,04 09,19,00 10,19,00 11,19,00 12,19,00 13,19,00 00,00,04 00,00,04 00,00,04 00,00,04 00,00,04 00,00,04 00,14,00 01,14,00 02,14,00 03,14,00 04,14,00 05,06,04 03,00,00 00,00,02 00,00,04 00,00,04 00,00,04 00,00,04 00,00,04 00,00,04
06,01,00 06,01,00 06,01,00 06,01,00 06,01,00 06,01,00 06,01,00 00,05,00 00,00,04 00,00,04 00,00,04 03,06,04 09,20,00 10,20,00 11,20,00 12,20,00 13,20,00 00,00,04 14,20,00 15,20,00 16,20,00 17,20,00 00,00,04 00,15,00 01,15,00 02,15,00 03,15,00 04,15,00 05,06,04 03,00,00 00,00,02 00,00,04 00,00,04 00,00,04 00,00,04 00,00,04 00,00,04
06,01,00 06,01,00 06,01,00 06,01,00 06,01,00 06,01,00 06,01,00 00,05,00 00,00,04 00,00,04 00,00,04 03,06,04 09,21,00 10,21,00 11,21,00 12,21,00 13,21,00 00,00,04 14,21,00 15,21,00 16,21,00 17,21,00 00,00,04 00,16,00 01,16,00 02,16,00 03,16,00 04,16,00 05,06,04 03,00,00 00,00,02 00,00,04 00,00,04 00,00,04 00,00,04 00,00,04 00,00,04
06,01,00 06,01,00 06,01,00 06,01,00 06,01,00 06,01,00 06,01,00 00,05,00 00,00,04 00,00,04 00,00,04 03,06,04 09,22,00 10,22,00 11,22,00 12,22,00 13,22,00 00,00,04 14,22,00 15,22,00 16,22,00 17,22,00 00,00,04 00,17,00 01,17,00 02,17,00 03,17,00 04,17,00 05,06,04 03,00,00 00,00,02 00,00,04 00,00,04 00,00,04 00,00,04 00,00,04 00,00,04
06,01,00 06,01,00 06,01,00 06,01,00 06,01,00 06,01,00 06,01,00 00,05,00 00,00,04 00,00,04 00,00,04 03,06,04 09,23,00 10,23,00 11,23,00 12,23,00 13,23,00 00,00,04 14,23,00 15,23,00 16,23,00 17,23,00 00,00,04 00,18,00 01,18,00 02,18,00 03,18,00 04,18,00 05,06,04 03,00,00 00,00,02 00,00,04 00,00,04 00,00,04 00,00,04 00,00,04 00,00,04
06,01,00 06,01,00 06,01,00 06,01,00 06,01,00 06,01,00 06,01,00 00,05,00 00,00,04 00,00,04 00,00,04 06,05,04 04,07,04 04,07,04 04,07,04 04,07,04 04,07,04 04,07,04 04,07,04 04,07,04 04,07,04 04,07,04 04,07,04 04,07,04 04,07,04 04,07,04 04,07,04 04,07,04 05,07,04 03,00,00 00,00,02 00,00,04 00,00,04 00,00,04 00,00,04 00,00,04 00,00,04
06,01,00 06,01,00 06,01,00 06,01,00 06,01,00 06,01,00 06,01,00 00,05,00 00,00,04 00,00,04 00,00,04 06,06,04 04,08,04 04,08,04 04,08,04 04,08,04 04,08,04 04,08,04 04,08,04 04,08,04 04,08,04 04,08,04 04,08,04 04,08,04 04,08,04 04,08,04 04,08,04 04,08,04 05,08,04 03,00,00 00,00,02 00,00,04 00,00,04 00,00,04 00,00,04 00,00,04 00,00,04
06,01,00 06,01,00 06,01,00 06,01,00 06,01,00 06,01,00 06,01,00 00,05,00 00,00,04 00,00,04 00,00,04 03,06,04 10,02,00 08,03,00 08,03,00 08,03,00 08,03,00 08,03,00 08,03,00 08,03,00 08,03,00 08,03,00 08,03,00 08,03,00 08,03,00 08,03,00 08,03,00 08,03,00 10,03,00 03,00,00 00,00,04 00,00,04 00,00,04 00,00,04 00,00,04 00,00,04 00,00,04
06,01,00 06,01,00 06,01,00 06,01,00 06,01,00 06,01,00 06,01,00 00,05,00 03,00,00 00,00,04 00,00,04 03,06,04 00,00,04 00,00,04 00,00,04 00,00,04 00,00,04 00,00,04 00,00,04 00,00,04 00,00,04 00,00,04 00,00,04 00,00,04 00,00,04 00,00,04 00,00,04 00,00,04 00,00,04 00,00,04 00,00,04 00,00,04 00,00,04 00,00,04 00,00,04 00,00,04 00,00,04
06,01,00 06,01,00 06,01,00 06,01,00 06,01,00 06,01,00 06,01,00 00,05,00 03,00,00 00,00,04 00,00,04 03,06,04 00,00,04 00,00,04 00,00,04 00,00,04 00,00,04 00,00,04 00,00,04 00,01,04 01,01,04 01,01,04 01,01,04 01,01,04 01,01,04 01,01,04 01,01,04 01,01,04 01,01,04 01,01,04 01,01,02 01,01,04 01,01,04 01,01,04 01,01,04 01,01,04 01,01,04
06,01,00 06,01,00 06,01,00 06,01,00 06,01,00 06,01,00 06,01,00 00,05,00 03,00,00 03,00,00 00,00,04 03,06,04 00,00,04 00,00,04 00,00,04 00,00,04 00,00,04 00,00,04 00,00,04 00,02,04 03,01,04 04,01,04 04,01,04 04,01,04 04,01,04 04,01,04 04,01,04 04,01,04 04,01,04 04,01,04 04,01,02 04,01,00 04,01,00 04,01,00 04,01,00 04,01,00 04,01,00
06,01,00 06,01,00 06,01,00 06,01,00 06,01,00 06,01,00 06,01,00 00,05,00 03,00,00 03,00,00 00,00,04 03,06,04 00,00,04 00,00,04 00,00,04 00,00,04 00,00,04 00,00,04 00,00,04 00,02,04 03,02,04 06,02,00 06,02,00 06,02,00 06,02,00 06,02,00 06,02,00 06,02,00 06,02,00 06,02,00 06,02,00 06,02,00 06,02,00 06,02,00 06,02,00 06,02,00 06,02,00
06,01,00 06,01,00 06,01,00 06,01,00 06,01,00 06,01,00 06,01,00 00,05,00 03,00,00 03,00,00 03,00,00 03,06,04 00,00,04 00,00,04 00,00,04 00,00,04 00,00,04 00,00,04 00,00,04 00,02,04 03,02,04 06,02,00 06,02,00 06,02,00 06,02,00 06,02,00 06,02,00 06,02,00 06,02,00 06,02,00 06,02,00 06,02,00 06,02,00 06,02,00 06,02,00 06,02,00 06,02,00
06,01,00 06,01,00 06,01,00 06,01,00 06,01,00 06,01,00 06,01,00 00,05,00 03,00,00 03,00,00 03,00,00 03,06,04 03,00,00 03,00,00 03,00,00 03,00,00 00,00,04 00,00,04 00,00,04 00,02,04 03,02,04 06,02,00 06,02,00 06,02,00 06,02,00 06,02,00 06,02,00 06,02,00 06,02,00 06,02,00 06,02,00 06,02,00 06,02,00 06,02,00 06,02,00 06,02,00 06,02,00
06,01,00 06,01,00 06,01,00 06,01,00 06,01,00 06,01,00 06,01,00 00,05,00 03,00,00 03,00,00 03,00,00 03,06,04 03,00,00 03,00,00 03,00,00 03,00,00 03,00,00 00,00,04 00,00,04 00,02,04 03,02,04 06,02,00 06,02,00 06,02,00 06,02,00 06,02,00 06,02,00 06,02,00 06,02,00 06,02,00 06,02,00 06,02,00 06,02,00 06,02,00 06,02,00 06,02,00 06,02,00
06,01,00 06,01,00 06,01,00 06,01,00 06,01,00 06,01,00 06,01,00 00,05,00 03,00,00 03,00,00 03,00,00 03,06,03 03,00,00 03,00,00 03,00,00 03,00,00 03,00,00 03,00,00 00,00,03 00,02,03 03,02,03 06,02,00 06,02,00 06,02,00 06,02,00 06,02,00 06,02,00 06,02,00 06,02,00 06,02,00 06,02,00 06,02,00 06,02,00 06,02,00 06,02,00 06,02,00 06,02,00
06,01,00 06,01,00 06,01,00 06,01,00 06,01,00 06,01,00 06,01,00 00,05,00 03,00,00 03,00,00 03,00,00 03,06,04 03,00,00 03,00,00 03,00,00 03,00,00 03,00,00 03,00,00 00,00,04 00,02,04 03,02,04 06,02,00 06,02,00 06,02,00 06,02,00 06,02,00 06,02,00 06,02,00 06,02,00 06,02,00 06,02,00 06,02,00 06,02,00 06,02,00 06,02,00 06,02,00 06,02,00
06,01,00 06,01,00 06,01,00 06,01,00 06,01,00 06,01,00 06,01,00 00,05,00 03,00,00 03,00,00 03,00,00 03,06,04 03,00,00 03,00,00 03,00,00 03,00,00 03,00,00 03,00,00 00,00,04 00,02,04 03,02,04 06,02,00 06,02,00 06,02,00 06,02,00 06,02,00 06,02,00 06,02,00 06,02,00 06,02,00 06,02,00 06,02,00 06,02,00 06,02,00 06,02,00 06,02,00 06,02,00
06,01,00 06,01,00 06,01,00 06,01,00 06,01,00 06,01,00 06,01,00 00,05,00 03,00,00 03,00,00 03,00,00 03,06,04 12,03,00 03,00,00 03,00,00 03,00,00 03,00,00 03,00,00 03,00,00 00,02,04 03,02,04 06,02,00 06,02,00 06,02,00 06,02,00 06,02,00 06,02,00 06,02,00 06,02,00 06,02,00 06,02,00 06,02,00 06,02,00 06,02,00 06,02,00 06,02,00 06,02,00
06,01,00 06,01,00 06,01,00 06,01,00 06,01,00 06,01,00 06,01,00 00,05,00 03,00,00 03,00,00 03,00,00 03,06,04 07,02,00 03,00,00 03,00,00 03,00,00 03,00,00 03,00,00 03,00,00 00,02,04 03,02,04 06,02,00 06,02,00 06,02,00 06,02,00 06,02,00 06,02,00 06,02,00 06,02,00 06,02,00 06,02,00 06,02,00 06,02,00 06,02,00 06,02,00 06,02,00 06,02,00
06,01,00 06,01,00 06,01,00 06,01,00 06,01,00 06,01,00 06,01,00 00,05,00 03,00,00 03,00,00 07,00,04 03,06,04 07,02,00 00,00,04 03,00,00 03,00,00 03,00,00 03,00,00 03,00,00 00,02,04 03,02,04 06,02,00 06,02,00 06,02,00 06,02,00 06,02,00 06,02,00 06,02,00 06,02,00 06,02,00 06,02,00 06,02,00 06,02,00 06,02,00 06,02,00 06,02,00 06,02,00
06,01,00 06,01,00 06,01,00 06,01,00 06,01,00 06,01,00 06,01,00 00,05,00 03,00,00 03,00,00 07,00,04 03,06,04 07,02,00 00,00,04 03,00,00 03,00,00 03,00,00 03,00,00 00,00,04 00,02,04 03,03,04 04,03,04 04,03,04 04,03,04 04,03,04 04,03,04 04,03,04 04,03,04 04,03,04 04,03,04 04,03,04 04,03,04 04,03,04 04,03,04 04,03,04 04,03,04 04,03,04