06,01,00 06,01,00 06,01,00 06,01,00 06,01,00 06,01,00 06,01,00 06,01,00 06,01,00 06,01,00 06,01,00 06,01,00 06,01,00 06,01,00 06,01,00 06,01,00 06,01,00 06,01,00 06,01,00 06,01,00 06,01,00 06,01,00 06,01,00 06,01,00 06,01,00 06,01,00 06,01,00 06,01,00 06,01,00 06,01,00 06,01,00 06,01,00 06,01,00 06,01,00 06,01,00 06,01,00 06,01,00
06,01,00 06,01,00 06,01,00 06,01,00 06,01,00 06,01,00 06,01,00 06,01,00 06,01,00 06,01,00 06,01,00 06,01,00 06,01,00 06,01,00 06,01,00 06,01,00 06,01,00 06,01,00 06,01,00 06,01,00 06,01,00 06,01,00 06,01,00 06,01,00 06,01,00 06,01,00 06,01,00 06,01,00 06,01,00 06,01,00 06,01,00 06,01,00 06,01,00 06,01,00 06,01,00 06,01,00 06,01,00
06,01,00 06,01,00 06,01,00 06,01,00 06,01,00 06,01,00 06,01,00 06,01,00 06,01,00 06,01,00 06,01,00 06,01,00 06,01,00 06,01,00 06,01,00 06,01,00 06,01,00 06,01,00 06,01,00 06,01,00 06,01,00 06,01,00 06,01,00 06,01,00 06,01,00 06,01,00 06,01,00 06,01,00 06,01,00 06,01,00 06,01,00 06,01,00 06,01,00 06,01,00 06,01,00 06,01,00 06,01,00
06,01,00 06,01,00 06,01,00 06,01,00 06,01,00 06,01,00 06,01,00 06,01,00 06,01,00 06,01,00 06,01,00 06,01,00 06,01,00 06,01,00 06,01,00 06,01,00 06,01,00 06,01,00 06,01,00 06,01,00 06,01,00 06,01,00 06,01,00 06,01,00 06,01,00 06,01,00 06,01,00 06,01,00 06,01,00 06,01,00 06,01,00 06,01,00 06,01,00 06,01,00 06,01,00 06,01,00 06,01,00
06,01,00 06,01,00 06,01,00 06,01,00 06,01,00 06,01,00 06,01,00 06,01,00 06,01,00 06,01,00 06,01,00 06,01,00 06,01,00 06,01,00 06,01,00 06,01,00 06,01,00 06,01,00 06,01,00 06,01,00 06,01,00 06,01,00 06,01,00 06,01,00 06,01,00 06,01,00 06,01,00 06,01,00 06,01,00 06,01,00 06,01,00 06,01,00 06,01,00 06,01,00 06,01,00 06,01,00 06,01,00
06,01,00 06,01,00 06,01,00 06,01,00 06,01,00 06,01,00 06,01,00 06,01,00 06,01,00 06,01,00 06,01,00 06,01,00 06,01,00 06,01,00 06,01,00 06,01,00 06,01,00 06,01,00 06,01,00 06,01,00 06,01,00 06,01,00 06,01,00 06,01,00 06,01,00 06,01,00 06,01,00 06,01,00 06,01,00 06,01,00 06,01,00 06,01,00 06,01,00 06,01,00 06,01,00 06,01,00 06,01,00
06,01,00 06,01,00 06,01,00 06,01,00 06,01,00 06,01,00 06,01,00 06,01,00 06,01,00 06,01,00 06,01,00 06,01,00 06,01,00 06,01,00 06,01,00 06,01,00 06,01,00 06,01,00 06,01,00 06,01,00 06,01,00 06,01,00 06,01,00 06,01,00 06,01,00 06,01,00 06,01,00 06,01,00 06,01,00 06,01,00 06,01,00 06,01,00 06,01,00 06,01,00 06,01,00 06,01,00 06,01,00
01,04,00 01,04,00 01,04,00 01,04,00 01,04,00 01,04,00 01,04,00 01,04,04 01,04,04 01,04,04 01,04,04 01,04,04 01,04,04 01,04,04 01,04,04 01,04,04 01,04,04 01,04,04 01,04,04 01,04,04 01,04,04 01,04,04 01,04,04 01,04,04 01,04,04 01,04,04 01,04,04 01,04,04 01,04,04 02,04,04 06,01,00 06,01,00 06,01,00 06,01,00 06,01,00 06,01,00 06,01,00
05,15,00 06,15,00 07,15,00 08,15,00 09,15,00 00,00,04 03,00,00 00,00,04 00,00,04 00,00,04 00,00,04 00,00,04 00,00,04 00,00,04 00,00,04 00,00,04 00,00,04 00,00,04 00,00,04 00,00,04 00,00,04 00,00,04 00,00,04 00,00,04 00,00,04 00,00,04 00,00,04 00,00,04 00,00,04 02,05,04 06,01,00 06,01,00 06,01,00 06,01,00 06,01,00 06,01,00 06,01,00
05,16,00 06,16,00 07,16,00 08,16,00 09,16,00 00,00,04 03,00,00 00,00,04 00,00,04 00,00,04 00,00,04 00,00,04 00,00,04 00,00,04 00,00,04 00,00,04 00,00,04 00,00,04 00,00,04 00,00,04 00,00,04 00,00,04 00,00,04 00,00,04 00,00,04 00,00,04 00,00,04 00,00,04 00,00,04 02,05,04 06,01,00 06,01,00 06,01,00 06,01,00 06,01,00 06,01,00 06,01,00
05,17,00 06,17,00 07,17,00 08,17,00 09,17,00 00,00,04 03,00,00 00,00,04 00,00,04 00,00,04 00,00,04 00,00,04 00,00,04 00,00,04 00,00,04 00,00,04 00,00,04 00,00,04 00,00,04 00,00,04 00,00,04 00,00,04 00,00,04 00,00,04 00,00,04 00,00,04 00,00,04 00,00,04 00,00,04 02,05,04 06,01,00 06,01,00 06,01,00 06,01,00 06,01,00 06,01,00 06,01,00
05,18,00 06,18,00 07,18,00 08,18,00 09,18,00 00,00,04 03,00,00 00,00,04 00,00,04 00,00,04 00,00,04 00,00,04 00,00,04 00,00,04 00,00,04 00,00,04 00,00,04 00,00,04 00,00,04 00,00,04 00,00,04 00,00,04 00,00,04 00,00,04 00,00,04 00,00,04 00,00,04 00,00,04 00,00,04 02,05,04 06,01,00 06,01,00 06,01,00 06,01,00 06,01,00 06,01,00 06,01,00
04,04,04 04,04,04 04,04,04 04,04,04 04,04,04 04,04,04 04,04,01 00,00,04 00,00,04 00,00,04 00,00,04 00,00,04 00,00,04 00,00,04 00,00,04 00,00,04 00,00,04 00,00,04 00,00,04 00,00,04 00,00,04 00,00,04 00,00,04 00,00,04 00,00,04 00,00,04 00,00,04 00,00,04 00,00,04 02,05,04 06,01,00 06,01,00 06,01,00 06,01,00 06,01,00 06,01,00 06,01,00
04,05,04 04,05,04 04,05,04 04,05,04 04,05,04 06,04,04 04,05,01 00,00,04 00,00,04 00,00,04 00,00,04 00,00,04 00,00,04 00,00,04 00,00,04 00,00,04 00,00,04 00,00,04 00,00,04 00,00,04 00,00,04 00,00,04 00,00,04 00,00,04 00,00,04 00,00,04 00,00,04 00,00,04 00,00,04 02,05,04 06,01,00 06,01,00 06,01,00 06,01,00 06,01,00 06,01,00 06,01,00
05,00,00 05,00,00 05,00,00 05,00,00 06,00,00 05,06,04 03,00,00 00,00,04 00,00,04 00,00,04 00,00,04 00,00,04 00,00,04 00,00,04 00,00,04 00,00,04 00,00,04 00,00,04 00,00,04 00,00,04 00,00,04 00,00,04 00,00,04 00,00,04 00,00,04 00,00,04 00,00,04 00,00,04 00,00,04 02,05,04 06,01,00 06,01,00 06,01,00 06,01,00 06,01,00 06,01,00 06,01,00
00,14,00 01,14,00 02,14,00 03,14,00 04,14,00 05,06,04 03,00,00 00,00,04 00,00,04 00,00,04 00,00,04 00,00,04 00,00,04 00,00,04 00,00,04 00,00,04 00,00,04 00,00,04 00,00,04 00,00,04 00,00,04 00,00,04 00,00,04 00,00,04 00,00,04 00,00,04 00,00,04 00,00,04 00,00,04 02,05,04 06,01,00 06,01,00 06,01,00 06,01,00 06,01,00 06,01,00 06,01,00
00,15,00 01,15,00 02,15,00 03,15,00 04,15,00 05,06,04 03,00,00 00,00,04 00,00,04 00,00,04 00,00,04 00,00,04 00,00,04 00,00,04 00,00,04 00,00,04 00,00,04 00,00,04 00,00,04 00,00,04 00,00,04 00,00,04 00,00,04 00,00,04 00,00,04 00,00,04 00,00,04 00,00,04 00,00,04 02,05,04 06,01,00 06,01,00 06,01,00 06,01,00 06,01,00 06,01,00 06,01,00
00,16,00 01,16,00 02,16,00 03,16,00 04,16,00 05,06,04 03,00,00 00,00,04 00,00,04 00,00,04 00,00,04 00,00,04 00,00,04 00,00,04 00,00,04 00,00,04 00,00,04 00,00,04 00,00,04 00,00,04 00,00,04 00,00,04 00,00,04 00,00,04 00,00,04 00,00,04 00,00,04 00,00,04 00,00,04 02,05,04 06,01,00 06,01,00 06,01,00 06,01,00 06,01,00 06,01,00 06,01,00
00,17,00 01,17,00 02,17,00 03,17,00 04,17,00 05,06,04 03,00,00 00,00,04 00,00,04 00,00,04 00,00,04 00,00,04 00,00,04 00,00,04 00,00,04 00,00,04 00,00,04 00,00,04 00,00,04 00,00,04 00,00,04 00,00,04 00,00,04 00,00,04 00,00,04 00,00,04 00,00,04 00,00,04 00,00,04 02,05,04 06,01,00 06,01,00 06,01,00 06,01,00 06,01,00 06,01,00 06,01,00
00,18,00 01,18,00 02,18,00 03,18,00 04,18,00 05,06,04 03,00,00 00,00,04 00,00,04 00,00,04 00,00,04 00,00,04 00,00,04 00,00,04 00,00,04 00,00,04 00,00,04 00,00,04 00,00,04 00,00,04 00,00,04 00,00,04 00,00,04 00,00,04 00,00,04 00,00,04 00,00,04 00,00,04 00,00,04 02,05,04 06,01,00 06,01,00 06,01,00 06,01,00 06,01,00 06,01,00 06,01,00
04,07,04 04,07,04 04,07,04 04,07,04 04,07,04 05,07,04 03,00,00 00,00,04 00,00,04 00,00,04 00,00,04 00,00,04 00,00,04 00,00,04 00,00,04 00,00,04 00,00,04 00,00,04 00,00,04 00,00,04 00,00,04 00,00,04 00,00,04 00,00,04 00,00,04 00,00,04 00,00,04 00,00,04 00,00,04 02,05,04 06,01,00 06,01,00 06,01,00 06,01,00 06,01,00 06,01,00 06,01,00
04,08,04 04,08,04 04,08,04 04,08,04 04,08,04 05,08,04 03,00,00 00,00,04 00,00,04 00,00,04 00,00,04 00,00,04 00,00,04 00,00,04 00,00,04 00,00,04 00,00,04 00,00,04 00,00,04 00,00,04 00,00,04 00,00,04 00,00,04 00,00,04 00,00,04 00,00,04 00,00,04 00,00,04 00,00,04 02,05,04 06,01,00 06,01,00 06,01,00 06,01,00 06,01,00 06,01,00 06,01,00
08,03,00 08,03,00 08,03,00 08,03,00 08,03,00 10,03,00 03,00,00 00,00,04 00,00,04 00,00,04 00,00,04 00,00,04 00,00,04 00,00,04 00,00,04 00,00,04 00,00,04 00,00,04 00,00,04 00,00,04 00,00,04 00,00,04 00,00,04 00,00,04 00,00,04 00,00,04 00,00,04 00,00,04 00,00,04 02,05,04 06,01,00 06,01,00 06,01,00 06,01,00 06,01,00 06,01,00 06,01,00
00,00,04 00,00,04 00,00,04 00,00,04 00,00,04 00,00,04 00,00,01 00,00,04 00,00,04 00,00,04 00,00,04 00,00,04 00,00,04 00,00,04 00,00,04 00,00,04 00,00,04 00,00,04 00,00,04 00,00,04 00,00,04 00,00,04 00,00,04 00,00,04 00,00,04 00,00,04 00,00,04 00,00,04 00,00,04 02,05,04 06,01,00 06,01,00 06,01,00 06,01,00 06,01,00 06,01,00 06,01,00
01,01,04 01,01,04 01,01,04 01,01,04 01,01,04 01,01,04 01,01,01 01,01,04 01,01,04 01,01,04 01,01,04 01,01,04 01,01,04 01,01,04 01,01,04 01,01,04 01,01,04 02,01,04 00,00,04 00,00,04 00,00,04 00,00,04 00,00,04 00,00,04 00,00,04 00,00,04 00,00,04 00,00,04 00,00,04 02,05,04 06,01,00 06,01,00 06,01,00 06,01,00 06,01,00 06,01,00 06,01,00
04,01,04 04,01,04 04,01,04 04,01,04 04,01,04 04,01,04 04,01,01 04,01,04 04,01,04 04,01,04 04,01,04 04,01,04 04,01,04 04,01,04 04,01,04 04,01,04 05,01,04 02,02,04 00,00,04 00,00,04 00,00,04 00,00,04 00,00,04 00,00,04 00,00,04 00,00,04 00,00,04 00,00,04 00,00,04 02,05,04 06,01,00 06,01,00 06,01,00 06,01,00 06,01,00 06,01,00 06,01,00
06,02,00 06,02,00 06,02,00 06,02,00 06,02,00 06,02,00 06,02,00 06,02,00 06,02,00 06,02,00 06,02,00 06,02,00 06,02,00 06,02,00 06,02,00 06,02,00 05,02,04 02,02,04 00,00,04 00,00,04 00,00,04 00,00,04 00,00,04 00,00,04 00,00,04 00,00,04 00,00,04 00,00,04 00,00,04 02,05,04 06,01,00 06,01,00 06,01,00 06,01,00 06,01,00 06,01,00 06,01,00
06,02,00 06,02,00 06,02,00 06,02,00 06,02,00 06,02,00 06,02,00 06,02,00 06,02,00 06,02,00 06,02,00 06,02,00 06,02,00 06,02,00 06,02,00 06,02,00 05,02,04 02,02,04 00,00,04 00,00,04 00,00,04 00,00,04 00,00,04 00,00,04 00,00,04 00,00,04 00,00,04 00,00,04 00,00,04 02,05,04 06,01,00 06,01,00 06,01,00 06,01,00 06,01,00 06,01,00 06,01,00
06,02,00 06,02,00 06,02,00 06,02,00 06,02,00 06,02,00 06,02,00 06,02,00 06,02,00 06,02,00 06,02,00 06,02,00 06,02,00 06,02,00 06,02,00 06,02,00 05,02,04 02,02,04 00,00,04 00,00,04 00,00,04 00,00,04 00,00,04 00,00,04 00,00,04 00,00,04 00,00,04 00,00,04 00,00,04 02,05,04 06,01,00 06,01,00 06,01,00 06,01,00 06,01,00 06,01,00 06,01,00
06,02,00 06,02,00 06,02,00 06,02,00 06,02,00 06,02,00 06,02,00 06,02,00 06,02,00 06,02,00 06,02,00 06,02,00 06,02,00 06,02,00 06,02,00 06,02,00 05,02,04 02,02,04 00,00,04 00,00,04 00,00,04 00,00,04 00,00,04 00,00,04 00,00,04 00,00,04 00,00,04 00,00,04 00,00,04 02,05,04 06,01,00 06,01,00 06,01,00 06,01,00 06,01,00 06,01,00 06,01,00
06,02,00 06,02,00 06,02,00 06,02,00 06,02,00 06,02,00 06,02,00 06,02,00 06,02,00 06,02,00 06,02,00 06,02,00 06,02,00 06,02,00 06,02,00 06,02,00 05,02,03 02,02,03 00,00,03 00,00,03 00,00,03 00,00,03 00,00,03 00,00,03 00,00,03 00,00,03 00,00,03 00,00,03 00,00,03 02,05,03 06,01,00 06,01,00 06,01,00 06,01,00 06,01,00 06,01,00 06,01,00
06,02,00 06,02,00 06,02,00 06,02,00 06,02,00 06,02,00 06,02,00 06,02,00 06,02,00 06,02,00 06,02,00 06,02,00 06,02,00 06,02,00 06,02,00 06,02,00 05,02,04 02,02,04 00,00,04 00,00,04 00,00,04 00,00,04 00,00,04 00,00,04 00,00,04 00,00,04 00,00,04 00,00,04 00,00,04 02,05,04 06,01,00 06,01,00 06,01,00 06,01,00 06,01,00 06,01,00 06,01,00
06,02,00 06,02,00 06,02,00 06,02,00 06,02,00 06,02,00 06,02,00 06,02,00 06,02,00 06,02,00 06,02,00 06,02,00 06,02,00 06,02,00 06,02,00 06,02,00 05,02,04 02,02,04 00,00,04 00,00,04 00,00,04 00,00,04 00,00,04 00,00,04 00,00,04 00,00,04 00,00,04 00,00,04 00,00,04 02,05,04 06,01,00 06,01,00 06,01,00 06,01,00 06,01,00 06,01,00 06,01,00
06,02,00 06,02,00 06,02,00 06,02,00 06,02,00 06,02,00 06,02,00 06,02,00 06,02,00 06,02,00 06,02,00 06,02,00 06,02,00 06,02,00 06,02,00 06,02,00 05,02,04 02,02,04 00,00,04 00,00,04 00,00,04 00,00,04 00,00,04 00,00,04 00,00,04 00,00,04 00,00,04 00,00,04 00,00,04 02,05,04 06,01,00 06,01,00 06,01,00 06,01,00 06,01,00 06,01,00 06,01,00
06,02,00 06,02,00 06,02,00 06,02,00 06,02,00 06,02,00 06,02,00 06,02,00 06,02,00 06,02,00 06,02,00 06,02,00 06,02,00 06,02,00 06,02,00 06,02,00 05,02,04 02,02,04 00,00,04 00,00,04 00,00,04 00,00,04 00,00,04 00,00,04 00,00,04 00,00,04 00,00,04 00,00,04 00,00,04 02,05,04 06,01,00 06,01,00 06,01,00 06,01,00 06,01,00 06,01,00 06,01,00
06,02,00 06,02,00 06,02,00 06,02,00 06,02,00 06,02,00 06,02,00 06,02,00 06,02,00 06,02,00 06,02,00 06,02,00 06,02,00 06,02,00 06,02,00 06,02,00 05,02,04 02,02,04 00,00,04 00,00,04 00,00,04 00,00,04 00,00,04 00,00,04 00,00,04 00,00,04 00,00,04 00,00,04 00,00,04 02,05,04 06,01,00 06,01,00 06,01,00 06,01,00 06,01,00 06,01,00 06,01,00
04,03,04 04,03,04 04,03,04 04,03,04 04,03,04 04,03,04 04,03,04 06,02,00 06,02,00 06,02,00 06,02,00 06,02,00 06,02,00 06,02,00 06,02,00 06,02,00 05,02,04 02,02,04 00,00,04 00,00,04 00,00,04 00,00,04 00,00,04 00,00,04 00,00,04 00,00,04 00,00,04 00,00,04 00,00,04 02,05,04 06,01,00 06,01,00 06,01,00 06,01,00 06,01,00 06,01,00 06,01,00