06,01,00 06,01,00 06,01,00 06,01,00 06,01,00 06,01,00 06,01,00 06,01,00 06,01,00 06,01,00 06,01,00 06,01,00 06,01,00 06,01,00 06,01,00 06,01,00 06,01,00 06,01,00 06,01,00 06,01,00 06,01,00 06,01,00 06,01,00 06,01,00 06,01,00 06,01,00 06,01,00 06,01,00 06,01,00 06,01,00 06,01,00 06,01,00 06,01,00 06,01,00 06,01,00 06,01,00 06,01,00
06,01,00 06,01,00 06,01,00 06,01,00 06,01,00 06,01,00 06,01,00 06,01,00 06,01,00 06,01,00 06,01,00 06,01,00 06,01,00 06,01,00 06,01,00 06,01,00 06,01,00 06,01,00 06,01,00 06,01,00 06,01,00 06,01,00 06,01,00 06,01,00 06,01,00 06,01,00 06,01,00 06,01,00 06,01,00 06,01,00 06,01,00 06,01,00 06,01,00 06,01,00 06,01,00 06,01,00 06,01,00
06,01,00 06,01,00 06,01,00 06,01,00 06,01,00 06,01,00 06,01,00 06,01,00 06,01,00 06,01,00 06,01,00 06,01,00 06,01,00 06,01,00 06,01,00 06,01,00 06,01,00 06,01,00 06,01,00 06,01,00 06,01,00 06,01,00 06,01,00 06,01,00 06,01,00 06,01,00 06,01,00 06,01,00 06,01,00 06,01,00 06,01,00 06,01,00 06,01,00 06,01,00 06,01,00 06,01,00 06,01,00
06,01,00 06,01,00 06,01,00 06,01,00 06,01,00 06,01,00 06,01,00 06,01,00 06,01,00 06,01,00 06,01,00 06,01,00 06,01,00 06,01,00 06,01,00 06,01,00 06,01,00 06,01,00 06,01,00 06,01,00 06,01,00 06,01,00 06,01,00 06,01,00 06,01,00 06,01,00 06,01,00 06,01,00 06,01,00 06,01,00 06,01,00 06,01,00 06,01,00 06,01,00 06,01,00 06,01,00 06,01,00
06,01,00 06,01,00 06,01,00 06,01,00 06,01,00 06,01,00 06,01,00 06,01,00 06,01,00 06,01,00 06,01,00 06,01,00 06,01,00 06,01,00 06,01,00 06,01,00 06,01,00 06,01,00 06,01,00 06,01,00 06,01,00 06,01,00 06,01,00 06,01,00 06,01,00 06,01,00 06,01,00 06,01,00 06,01,00 06,01,00 06,01,00 06,01,00 06,01,00 06,01,00 06,01,00 06,01,00 06,01,00
06,01,00 06,01,00 06,01,00 06,01,00 06,01,00 06,01,00 06,01,00 06,01,00 06,01,00 06,01,00 06,01,00 06,01,00 06,01,00 06,01,00 06,01,00 06,01,00 06,01,00 06,01,00 06,01,00 06,01,00 06,01,00 06,01,00 06,01,00 06,01,00 06,01,00 06,01,00 06,01,00 06,01,00 06,01,00 06,01,00 06,01,00 06,01,00 06,01,00 06,01,00 06,01,00 06,01,00 06,01,00
06,01,00 06,01,00 06,01,00 06,01,00 06,01,00 06,01,00 06,01,00 06,01,00 06,01,00 06,01,00 06,01,00 06,01,00 06,01,00 06,01,00 06,01,00 06,01,00 06,01,00 06,01,00 06,01,00 06,01,00 06,01,00 06,01,00 06,01,00 06,01,00 06,01,00 06,01,00 06,01,00 06,01,00 06,01,00 06,01,00 06,01,00 06,01,00 06,01,00 06,01,00 06,01,00 06,01,00 06,01,00
01,04,00 01,04,00 01,04,04 01,04,04 01,04,04 01,04,04 01,04,01 01,04,04 01,04,04 01,04,04 01,04,04 01,04,04 01,04,04 01,04,04 01,04,04 01,04,04 01,04,04 01,04,04 01,04,04 01,04,04 01,04,04 01,04,04 01,04,04 01,04,04 01,04,04 01,04,04 01,04,04 01,04,04 01,04,04 02,04,04 06,01,00 06,01,00 06,01,00 06,01,00 06,01,00 06,01,00 06,01,00
00,00,00 00,00,00 00,00,04 00,00,04 00,00,04 00,00,04 00,00,01 00,00,04 00,00,04 00,00,04 00,00,04 00,00,04 00,00,04 00,00,04 00,00,04 00,00,04 00,00,04 00,00,04 00,00,04 00,00,04 00,00,04 00,00,04 00,00,04 00,00,04 00,00,04 00,00,04 00,00,04 00,00,04 00,00,04 02,05,04 06,01,00 06,01,00 06,01,00 06,01,00 06,01,00 06,01,00 06,01,00
00,00,00 00,00,00 00,00,04 00,00,04 00,00,04 00,00,04 00,00,01 00,00,04 00,00,04 00,00,04 00,00,04 00,00,04 00,00,04 00,00,04 00,00,04 00,00,04 00,00,04 00,00,04 00,00,04 00,00,04 00,00,04 00,00,04 00,00,04 00,00,04 00,00,04 00,00,04 00,00,04 00,00,04 00,00,04 02,05,04 06,01,00 06,01,00 06,01,00 06,01,00 06,01,00 06,01,00 06,01,00
00,00,00 00,00,00 00,00,04 00,00,04 00,00,04 00,00,04 00,00,01 00,00,04 00,00,04 00,00,04 00,00,04 00,00,04 00,00,04 00,00,04 00,00,04 00,00,04 00,00,04 00,00,04 00,00,04 00,00,04 00,00,04 00,00,04 00,00,04 00,00,04 00,00,04 00,00,04 00,00,04 00,00,04 00,00,04 02,05,04 06,01,00 06,01,00 06,01,00 06,01,00 06,01,00 06,01,00 06,01,00
00,00,00 00,00,00 00,00,04 00,00,04 00,00,04 00,00,04 00,00,01 00,00,04 00,00,04 00,00,04 00,00,04 00,00,04 00,00,04 00,00,04 00,00,04 00,00,04 00,00,04 00,00,04 00,00,04 00,00,04 00,00,04 00,00,04 00,00,04 00,00,04 00,00,04 00,00,04 00,00,04 00,00,04 00,00,04 02,05,04 06,01,00 06,01,00 06,01,00 06,01,00 06,01,00 06,01,00 06,01,00
00,00,00 00,00,00 00,00,04 00,00,04 00,00,04 00,00,04 00,00,01 00,00,04 00,00,04 00,00,04 00,00,04 00,00,04 00,00,04 00,00,04 00,00,04 00,00,04 00,00,04 00,00,04 00,00,04 00,00,04 00,00,04 00,00,04 00,00,04 00,00,04 00,00,04 00,00,04 00,00,04 00,00,04 00,00,04 02,05,04 06,01,00 06,01,00 06,01,00 06,01,00 06,01,00 06,01,00 06,01,00
00,00,00 00,00,00 00,00,04 00,00,04 00,00,04 00,00,04 00,00,01 00,00,04 00,00,04 00,00,04 00,00,04 00,00,04 00,00,04 00,00,04 00,00,04 00,00,04 00,00,04 00,00,04 00,00,04 00,00,04 00,00,04 00,00,04 00,00,04 00,00,04 00,00,04 00,00,04 00,00,04 00,00,04 00,00,04 02,05,04 06,01,00 06,01,00 06,01,00 06,01,00 06,01,00 06,01,00 06,01,00
00,00,00 00,00,00 00,00,04 00,00,04 00,00,04 00,00,04 00,00,01 00,00,04 00,00,04 00,00,04 00,00,04 00,00,04 00,00,04 00,00,04 00,00,04 00,00,04 00,00,04 00,00,04 00,00,04 00,00,04 00,00,04 00,00,04 00,00,04 00,00,04 00,00,04 00,00,04 00,00,04 00,00,04 00,00,04 02,05,04 06,01,00 06,01,00 06,01,00 06,01,00 06,01,00 06,01,00 06,01,00
00,00,00 00,00,00 00,00,04 00,00,04 00,00,04 00,00,04 00,00,01 00,00,04 00,00,04 00,00,04 00,00,04 00,00,04 00,00,04 00,00,04 00,00,04 00,00,04 00,00,04 00,00,04 00,00,04 00,00,04 00,00,04 00,00,04 00,00,04 00,00,04 00,00,04 00,00,04 00,00,04 00,00,04 00,00,04 02,05,04 06,01,00 06,01,00 06,01,00 06,01,00 06,01,00 06,01,00 06,01,00
00,00,00 00,00,00 00,00,04 00,00,04 00,00,04 00,00,04 00,00,01 00,00,04 00,00,04 00,00,04 00,00,04 00,00,04 00,00,04 00,00,04 00,00,04 00,00,04 00,00,04 00,00,04 00,00,04 00,00,04 00,00,04 00,00,04 00,00,04 00,00,04 00,00,04 00,00,04 00,00,04 00,00,04 00,00,04 02,05,04 06,01,00 06,01,00 06,01,00 06,01,00 06,01,00 06,01,00 06,01,00
00,00,00 00,00,00 00,00,04 00,00,04 00,00,04 00,00,04 00,00,01 00,00,04 00,00,04 00,00,04 00,00,04 00,00,04 00,00,04 00,00,04 00,00,04 00,00,04 00,00,04 00,00,04 00,00,04 00,00,04 00,00,04 00,00,04 00,00,04 00,00,04 00,00,04 00,00,04 00,00,04 00,00,04 00,00,04 02,05,04 06,01,00 06,01,00 06,01,00 06,01,00 06,01,00 06,01,00 06,01,00
00,00,00 00,00,00 00,00,04 00,00,04 00,00,04 00,00,04 00,00,01 00,00,04 00,00,04 00,00,04 00,00,04 00,00,04 00,00,04 00,00,04 00,00,04 00,00,04 00,00,04 00,00,04 00,00,04 00,00,04 00,00,04 00,00,04 00,00,04 00,00,04 00,00,04 00,00,04 00,00,04 00,00,04 00,00,04 02,05,04 06,01,00 06,01,00 06,01,00 06,01,00 06,01,00 06,01,00 06,01,00
00,00,00 00,00,00 00,00,04 00,00,04 00,00,04 00,00,04 00,00,01 00,00,04 00,00,04 00,00,04 00,00,04 00,00,04 00,00,04 00,00,04 00,00,04 00,00,04 00,00,04 00,00,04 00,00,04 00,00,04 00,00,04 00,00,04 00,00,04 00,00,04 00,00,04 00,00,04 00,00,04 00,00,04 00,00,04 02,05,04 06,01,00 06,01,00 06,01,00 06,01,00 06,01,00 06,01,00 06,01,00
00,00,00 00,00,00 00,00,04 00,00,04 00,00,04 00,00,04 00,00,01 00,00,04 00,00,04 00,00,04 00,00,04 00,00,04 00,00,04 00,00,04 00,00,04 00,00,04 00,00,04 00,00,04 00,00,04 00,00,04 00,00,04 00,00,04 00,00,04 00,00,04 00,00,04 00,00,04 00,00,04 00,00,04 00,00,04 02,05,04 06,01,00 06,01,00 06,01,00 06,01,00 06,01,00 06,01,00 06,01,00
00,00,00 00,00,00 00,00,04 00,00,04 00,00,04 00,00,04 00,00,01 00,00,04 00,00,04 00,00,04 00,00,04 00,00,04 00,00,04 00,00,04 00,00,04 00,00,04 00,00,04 00,00,04 00,00,04 00,00,04 00,00,04 00,00,04 00,00,04 00,00,04 00,00,04 00,00,04 00,00,04 00,00,04 00,00,04 02,05,04 06,01,00 06,01,00 06,01,00 06,01,00 06,01,00 06,01,00 06,01,00
01,01,00 01,01,00 01,01,04 01,01,04 01,01,04 01,01,04 01,01,01 01,01,04 01,01,04 01,01,04 01,01,04 01,01,04 01,01,04 01,01,04 01,01,04 01,01,04 01,01,04 02,01,04 00,00,04 00,00,04 00,00,04 00,00,04 00,00,04 00,00,04 00,00,04 00,00,04 00,00,04 00,00,04 00,00,04 02,05,04 06,01,00 06,01,00 06,01,00 06,01,00 06,01,00 06,01,00 06,01,00
04,01,00 04,01,00 04,01,04 04,01,04 04,01,04 04,01,04 04,01,01 04,01,04 04,01,04 04,01,04 04,01,04 04,01,04 04,01,04 04,01,04 04,01,04 04,01,04 05,01,04 02,02,04 00,00,04 00,00,04 00,00,04 00,00,04 00,00,04 00,00,04 00,00,04 00,00,04 00,00,04 00,00,04 00,00,04 02,05,04 06,01,00 06,01,00 06,01,00 06,01,00 06,01,00 06,01,00 06,01,00
06,02,00 06,02,00 06,02,00 06,02,00 06,02,00 06,02,00 06,02,00 06,02,00 06,02,00 06,02,00 06,02,00 06,02,00 06,02,00 06,02,00 06,02,00 06,02,00 05,02,04 02,02,04 00,00,04 00,00,04 00,00,04 00,00,04 00,00,04 00,00,04 00,00,04 00,00,04 00,00,04 00,00,04 00,00,04 02,05,04 06,01,00 06,01,00 06,01,00 06,01,00 06,01,00 06,01,00 06,01,00
06,02,00 06,02,00 06,02,00 06,02,00 06,02,00 06,02,00 06,02,00 06,02,00 06,02,00 06,02,00 06,02,00 06,02,00 06,02,00 06,02,00 06,02,00 06,02,00 05,02,04 02,02,04 00,00,04 00,00,04 00,00,04 00,00,04 00,00,04 00,00,04 00,00,04 00,00,04 00,00,04 00,00,04 00,00,04 02,05,04 06,01,00 06,01,00 06,01,00 06,01,00 06,01,00 06,01,00 06,01,00
06,02,00 06,02,00 06,02,00 06,02,00 06,02,00 06,02,00 06,02,00 06,02,00 06,02,00 06,02,00 06,02,00 06,02,00 06,02,00 06,02,00 06,02,00 06,02,00 05,02,04 02,02,04 00,00,04 00,00,04 00,00,04 00,00,04 00,00,04 00,00,04 00,00,04 00,00,04 00,00,04 00,00,04 00,00,04 02,05,04 06,01,00 06,01,00 06,01,00 06,01,00 06,01,00 06,01,00 06,01,00
06,02,00 06,02,00 06,02,00 06,02,00 06,02,00 06,02,00 06,02,00 06,02,00 06,02,00 06,02,00 06,02,00 06,02,00 06,02,00 06,02,00 06,02,00 06,02,00 05,02,04 02,02,04 00,00,04 00,00,04 00,00,04 00,00,04 00,00,04 00,00,04 00,00,04 00,00,04 00,00,04 00,00,04 00,00,04 02,05,04 06,01,00 06,01,00 06,01,00 06,01,00 06,01,00 06,01,00 06,01,00
06,02,00 06,02,00 06,02,00 06,02,00 06,02,00 06,02,00 06,02,00 06,02,00 06,02,00 06,02,00 06,02,00 06,02,00 06,02,00 06,02,00 06,02,00 06,02,00 05,02,04 02,02,04 00,00,04 00,00,04 00,00,04 00,00,04 00,00,04 00,00,04 00,00,04 00,00,04 00,00,04 00,00,04 00,00,04 02,05,04 06,01,00 06,01,00 06,01,00 06,01,00 06,01,00 06,01,00 06,01,00
06,02,00 06,02,00 06,02,00 06,02,00 06,02,00 06,02,00 06,02,00 06,02,00 06,02,00 06,02,00 06,02,00 06,02,00 06,02,00 06,02,00 06,02,00 06,02,00 05,02,04 02,02,04 00,00,04 00,00,04 00,00,04 00,00,04 00,00,04 00,00,04 00,00,04 00,00,04 00,00,04 00,00,04 00,00,04 02,05,04 06,01,00 06,01,00 06,01,00 06,01,00 06,01,00 06,01,00 06,01,00
06,02,00 06,02,00 06,02,00 06,02,00 06,02,00 06,02,00 06,02,00 06,02,00 06,02,00 06,02,00 06,02,00 06,02,00 06,02,00 06,02,00 06,02,00 06,02,00 05,02,03 02,02,03 00,00,03 00,00,03 00,00,03 00,00,03 00,00,03 00,00,03 00,00,03 00,00,03 00,00,03 00,00,03 00,00,03 02,05,03 06,01,00 06,01,00 06,01,00 06,01,00 06,01,00 06,01,00 06,01,00
06,02,00 06,02,00 06,02,00 06,02,00 06,02,00 06,02,00 06,02,00 06,02,00 06,02,00 06,02,00 06,02,00 06,02,00 06,02,00 06,02,00 06,02,00 06,02,00 05,02,04 02,02,04 00,00,04 00,00,04 00,00,04 00,00,04 00,00,04 00,00,04 00,00,04 00,00,04 00,00,04 00,00,04 00,00,04 02,05,04 06,01,00 06,01,00 06,01,00 06,01,00 06,01,00 06,01,00 06,01,00
06,02,00 06,02,00 06,02,00 06,02,00 06,02,00 06,02,00 06,02,00 06,02,00 06,02,00 06,02,00 06,02,00 06,02,00 06,02,00 06,02,00 06,02,00 06,02,00 05,02,04 02,02,04 00,00,04 00,00,04 00,00,04 00,00,04 00,00,04 00,00,04 00,00,04 00,00,04 00,00,04 00,00,04 00,00,04 02,05,04 06,01,00 06,01,00 06,01,00 06,01,00 06,01,00 06,01,00 06,01,00
06,02,00 06,02,00 06,02,00 06,02,00 06,02,00 06,02,00 06,02,00 06,02,00 06,02,00 06,02,00 06,02,00 06,02,00 06,02,00 06,02,00 06,02,00 06,02,00 05,02,04 02,02,04 00,00,04 00,00,04 00,00,04 00,00,04 00,00,04 00,00,04 00,00,04 00,00,04 00,00,04 00,00,04 00,00,04 02,05,04 06,01,00 06,01,00 06,01,00 06,01,00 06,01,00 06,01,00 06,01,00
06,02,00 06,02,00 06,02,00 06,02,00 06,02,00 06,02,00 06,02,00 06,02,00 06,02,00 06,02,00 06,02,00 06,02,00 06,02,00 06,02,00 06,02,00 06,02,00 05,02,04 02,02,04 00,00,04 00,00,04 00,00,04 00,00,04 00,00,04 00,00,04 00,00,04 00,00,04 00,00,04 00,00,04 00,00,04 02,05,04 06,01,00 06,01,00 06,01,00 06,01,00 06,01,00 06,01,00 06,01,00
06,02,00 06,02,00 06,02,00 06,02,00 06,02,00 06,02,00 06,02,00 06,02,00 06,02,00 06,02,00 06,02,00 06,02,00 06,02,00 06,02,00 06,02,00 06,02,00 05,02,04 02,02,04 00,00,04 00,00,04 00,00,04 00,00,04 00,00,04 00,00,04 00,00,04 00,00,04 00,00,04 00,00,04 00,00,04 02,05,04 06,01,00 06,01,00 06,01,00 06,01,00 06,01,00 06,01,00 06,01,00
06,02,00 06,02,00 06,02,00 06,02,00 06,02,00 06,02,00 06,02,00 06,02,00 06,02,00 06,02,00 06,02,00 06,02,00 06,02,00 06,02,00 06,02,00 06,02,00 05,02,04 02,02,04 00,00,04 00,00,04 00,00,04 00,00,04 00,00,04 00,00,04 00,00,04 00,00,04 00,00,04 00,00,04 00,00,04 02,05,04 06,01,00 06,01,00 06,01,00 06,01,00 06,01,00 06,01,00 06,01,00