6,1,0 6,1,0 6,1,0 6,1,0 6,1,0 6,1,0 6,1,0 6,1,0 6,1,0 6,1,0 6,1,0 6,1,0 6,1,0 6,1,0 6,1,0 6,1,0 6,1,0 6,1,0 6,1,0 6,1,0 6,1,0 6,1,0 6,1,0 6,1,0 6,1,0 6,1,0 6,1,0 6,1,0 6,1,0 6,1,0 6,1,0 6,1,0 6,1,0 6,1,0 6,1,0
6,1,0 6,1,0 6,1,0 6,1,0 6,1,0 6,1,0 6,1,0 6,1,0 6,1,0 6,1,0 6,1,0 6,1,0 6,1,0 6,1,0 6,1,0 6,1,0 6,1,0 6,1,0 6,1,0 6,1,0 6,1,0 6,1,0 6,1,0 6,1,0 6,1,0 6,1,0 6,1,0 6,1,0 6,1,0 6,1,0 6,1,0 6,1,0 6,1,0 6,1,0 6,1,0
6,1,0 6,1,0 6,1,0 6,1,0 6,1,0 6,1,0 6,1,0 6,1,0 6,1,0 6,1,0 6,1,0 6,1,0 6,1,0 6,1,0 6,1,0 6,1,0 6,1,0 6,1,0 6,1,0 6,1,0 6,1,0 6,1,0 6,1,0 6,1,0 6,1,0 6,1,0 6,1,0 6,1,0 6,1,0 6,1,0 6,1,0 6,1,0 6,1,0 6,1,0 6,1,0
6,1,0 6,1,0 6,1,0 6,1,0 6,1,0 6,1,0 6,1,0 6,1,0 6,1,0 6,1,0 6,1,0 6,1,0 6,1,0 6,1,0 6,1,0 6,1,0 6,1,0 6,1,0 6,1,0 6,1,0 6,1,0 6,1,0 6,1,0 6,1,0 6,1,0 6,1,0 6,1,0 6,1,0 6,1,0 6,1,0 6,1,0 6,1,0 6,1,0 6,1,0 6,1,0
6,1,0 6,1,0 6,1,0 6,1,0 6,1,0 6,1,0 6,1,0 6,1,0 6,1,0 6,1,0 6,1,0 6,1,0 6,1,0 6,1,0 6,1,0 6,1,0 6,1,0 6,1,0 6,1,0 6,1,0 6,1,0 6,1,0 6,1,0 6,1,0 6,1,0 6,1,0 6,1,0 6,1,0 6,1,0 6,1,0 6,1,0 6,1,0 6,1,0 6,1,0 6,1,0
6,1,0 6,1,0 6,1,0 6,1,0 6,1,0 6,1,0 6,1,0 6,1,0 6,1,0 6,1,0 6,1,0 6,1,0 6,1,0 6,1,0 6,1,0 6,1,0 6,1,0 6,1,0 6,1,0 6,1,0 6,1,0 6,1,0 6,1,0 6,1,0 6,1,0 6,1,0 6,1,0 6,1,0 6,1,0 6,1,0 6,1,0 6,1,0 6,1,0 6,1,0 6,1,0
1,4,0 1,4,4 1,4,4 1,4,4 1,4,4 1,4,1 1,4,4 1,4,4 1,4,4 1,4,4 1,4,4 1,4,4 1,4,4 1,4,4 1,4,4 1,4,4 1,4,4 1,4,4 1,4,4 1,4,4 1,4,4 1,4,4 1,4,4 1,4,4 1,4,4 1,4,4 1,4,4 1,4,4 2,4,4 6,1,0 6,1,0 6,1,0 6,1,0 6,1,0 6,1,0
0,0,0 0,0,4 0,0,4 0,0,4 0,0,4 0,0,1 0,0,4 0,0,4 0,0,4 0,0,4 0,0,4 0,0,4 0,0,4 0,0,4 0,0,4 0,0,4 0,0,4 0,0,4 0,0,4 0,0,4 0,0,4 0,0,4 0,0,4 0,0,4 0,0,4 0,0,4 0,0,4 0,0,4 2,5,4 6,1,0 6,1,0 6,1,0 6,1,0 6,1,0 6,1,0
0,0,0 0,0,4 0,0,4 0,0,4 0,0,4 0,0,1 0,0,4 0,0,4 0,0,4 0,0,4 0,0,4 0,0,4 0,0,4 0,0,4 0,0,4 0,0,4 0,0,4 0,0,4 0,0,4 0,0,4 0,0,4 0,0,4 0,0,4 0,0,4 0,0,4 0,0,4 0,0,4 0,0,4 2,5,4 6,1,0 6,1,0 6,1,0 6,1,0 6,1,0 6,1,0
0,0,0 0,0,4 0,0,4 0,0,4 0,0,4 0,0,1 0,0,4 0,0,4 0,0,4 0,0,4 0,0,4 0,0,4 0,0,4 0,0,4 0,0,4 0,0,4 0,0,4 0,0,4 0,0,4 0,0,4 0,0,4 0,0,4 0,0,4 0,0,4 0,0,4 0,0,4 0,0,4 0,0,4 2,5,4 6,1,0 6,1,0 6,1,0 6,1,0 6,1,0 6,1,0
0,0,0 0,0,4 0,0,4 0,0,4 0,0,4 0,0,1 0,0,4 0,0,4 0,0,4 0,0,4 0,0,4 0,0,4 0,0,4 0,0,4 0,0,4 0,0,4 0,0,4 0,0,4 0,0,4 0,0,4 0,0,4 0,0,4 0,0,4 0,0,4 0,0,4 0,0,4 0,0,4 0,0,4 2,5,4 6,1,0 6,1,0 6,1,0 6,1,0 6,1,0 6,1,0
0,0,0 0,0,4 0,0,4 0,0,4 0,0,4 0,0,1 0,0,4 0,0,4 0,0,4 0,0,4 0,0,4 0,0,4 0,0,4 0,0,4 0,0,4 0,0,4 0,0,4 0,0,4 0,0,4 0,0,4 0,0,4 0,0,4 0,0,4 0,0,4 0,0,4 0,0,4 0,0,4 0,0,4 2,5,4 6,1,0 6,1,0 6,1,0 6,1,0 6,1,0 6,1,0
0,0,0 0,0,4 0,0,4 0,0,4 0,0,4 0,0,1 0,0,4 0,0,4 0,0,4 0,0,4 0,0,4 0,0,4 0,0,4 0,0,4 0,0,4 0,0,4 0,0,4 0,0,4 0,0,4 0,0,4 0,0,4 0,0,4 0,0,4 0,0,4 0,0,4 0,0,4 0,0,4 0,0,4 2,5,4 6,1,0 6,1,0 6,1,0 6,1,0 6,1,0 6,1,0
0,0,0 0,0,4 0,0,4 0,0,4 0,0,4 0,0,1 0,0,4 0,0,4 0,0,4 0,0,4 0,0,4 0,0,4 0,0,4 0,0,4 0,0,4 0,0,4 0,0,4 0,0,4 0,0,4 0,0,4 0,0,4 0,0,4 0,0,4 0,0,4 0,0,4 0,0,4 0,0,4 0,0,4 2,5,4 6,1,0 6,1,0 6,1,0 6,1,0 6,1,0 6,1,0
0,0,0 0,0,4 0,0,4 0,0,4 0,0,4 0,0,1 0,0,4 0,0,4 0,0,4 0,0,4 0,0,4 0,0,4 0,0,4 0,0,4 0,0,4 0,0,4 0,0,4 0,0,4 0,0,4 0,0,4 0,0,4 0,0,4 0,0,4 0,0,4 0,0,4 0,0,4 0,0,4 0,0,4 2,5,4 6,1,0 6,1,0 6,1,0 6,1,0 6,1,0 6,1,0
0,0,0 0,0,4 0,0,4 0,0,4 0,0,4 0,0,1 0,0,4 0,0,4 0,0,4 0,0,4 0,0,4 0,0,4 0,0,4 0,0,4 0,0,4 0,0,4 0,0,4 0,0,4 0,0,4 0,0,4 0,0,4 0,0,4 0,0,4 0,0,4 0,0,4 0,0,4 0,0,4 0,0,4 2,5,4 6,1,0 6,1,0 6,1,0 6,1,0 6,1,0 6,1,0
0,0,0 0,0,4 0,0,4 0,0,4 0,0,4 0,0,1 0,0,4 0,0,4 0,0,4 0,0,4 0,0,4 0,0,4 0,0,4 0,0,4 0,0,4 0,0,4 0,0,4 0,0,4 0,0,4 0,0,4 0,0,4 0,0,4 0,0,4 0,0,4 0,0,4 0,0,4 0,0,4 0,0,4 2,5,4 6,1,0 6,1,0 6,1,0 6,1,0 6,1,0 6,1,0
0,0,0 0,0,4 0,0,4 0,0,4 0,0,4 0,0,1 0,0,4 0,0,4 0,0,4 0,0,4 0,0,4 0,0,4 0,0,4 0,0,4 0,0,4 0,0,4 0,0,4 0,0,4 0,0,4 0,0,4 0,0,4 0,0,4 0,0,4 0,0,4 0,0,4 0,0,4 0,0,4 0,0,4 2,5,4 6,1,0 6,1,0 6,1,0 6,1,0 6,1,0 6,1,0
0,0,0 0,0,4 0,0,4 0,0,4 0,0,4 0,0,1 0,0,4 0,0,4 0,0,4 0,0,4 0,0,4 0,0,4 0,0,4 0,0,4 0,0,4 0,0,4 0,0,4 0,0,4 0,0,4 0,0,4 0,0,4 0,0,4 0,0,4 0,0,4 0,0,4 0,0,4 0,0,4 0,0,4 2,5,4 6,1,0 6,1,0 6,1,0 6,1,0 6,1,0 6,1,0
0,0,0 0,0,4 0,0,4 0,0,4 0,0,4 0,0,1 0,0,4 0,0,4 0,0,4 0,0,4 0,0,4 0,0,4 0,0,4 0,0,4 0,0,4 0,0,4 0,0,4 0,0,4 0,0,4 0,0,4 0,0,4 0,0,4 0,0,4 0,0,4 0,0,4 0,0,4 0,0,4 0,0,4 2,5,4 6,1,0 6,1,0 6,1,0 6,1,0 6,1,0 6,1,0
0,0,0 0,0,4 0,0,4 0,0,4 0,0,4 0,0,1 0,0,4 0,0,4 0,0,4 0,0,4 0,0,4 0,0,4 0,0,4 0,0,4 0,0,4 0,0,4 0,0,4 0,0,4 0,0,4 0,0,4 0,0,4 0,0,4 0,0,4 0,0,4 0,0,4 0,0,4 0,0,4 0,0,4 2,5,4 6,1,0 6,1,0 6,1,0 6,1,0 6,1,0 6,1,0
0,0,0 0,0,4 0,0,4 0,0,4 0,0,4 0,0,1 0,0,4 0,0,4 0,0,4 0,0,4 0,0,4 0,0,4 0,0,4 0,0,4 0,0,4 0,0,4 0,0,4 0,0,4 0,0,4 0,0,4 0,0,4 0,0,4 0,0,4 0,0,4 0,0,4 0,0,4 0,0,4 0,0,4 2,5,4 6,1,0 6,1,0 6,1,0 6,1,0 6,1,0 6,1,0
1,1,0 1,1,4 1,1,4 1,1,4 1,1,4 1,1,1 1,1,4 1,1,4 1,1,4 1,1,4 1,1,4 1,1,4 1,1,4 1,1,4 1,1,4 1,1,4 2,1,4 0,0,4 0,0,4 0,0,4 0,0,4 0,0,4 0,0,4 0,0,4 0,0,4 0,0,4 0,0,4 0,0,4 2,5,4 6,1,0 6,1,0 6,1,0 6,1,0 6,1,0 6,1,0
4,1,0 4,1,4 4,1,4 4,1,4 4,1,4 4,1,1 4,1,4 4,1,4 4,1,4 4,1,4 4,1,4 4,1,4 4,1,4 4,1,4 4,1,4 5,1,4 2,2,4 0,0,4 0,0,4 0,0,4 0,0,4 0,0,4 0,0,4 0,0,4 0,0,4 0,0,4 0,0,4 0,0,4 2,5,4 6,1,0 6,1,0 6,1,0 6,1,0 6,1,0 6,1,0
6,2,0 6,2,0 6,2,0 6,2,0 6,2,0 6,2,0 6,2,0 6,2,0 6,2,0 6,2,0 6,2,0 6,2,0 6,2,0 6,2,0 6,2,0 5,2,4 2,2,4 0,0,4 0,0,4 0,0,4 0,0,4 0,0,4 0,0,4 0,0,4 0,0,4 0,0,4 0,0,4 0,0,4 2,5,4 6,1,0 6,1,0 6,1,0 6,1,0 6,1,0 6,1,0
6,2,0 6,2,0 6,2,0 6,2,0 6,2,0 6,2,0 6,2,0 6,2,0 6,2,0 6,2,0 6,2,0 6,2,0 6,2,0 6,2,0 6,2,0 5,2,4 2,2,4 0,0,4 0,0,4 0,0,4 0,0,4 0,0,4 0,0,4 0,0,4 0,0,4 0,0,4 0,0,4 0,0,4 2,5,4 6,1,0 6,1,0 6,1,0 6,1,0 6,1,0 6,1,0
6,2,0 6,2,0 6,2,0 6,2,0 6,2,0 6,2,0 6,2,0 6,2,0 6,2,0 6,2,0 6,2,0 6,2,0 6,2,0 6,2,0 6,2,0 5,2,4 2,2,4 0,0,4 0,0,4 0,0,4 0,0,4 0,0,4 0,0,4 0,0,4 0,0,4 0,0,4 0,0,4 0,0,4 2,5,4 6,1,0 6,1,0 6,1,0 6,1,0 6,1,0 6,1,0
6,2,0 6,2,0 6,2,0 6,2,0 6,2,0 6,2,0 6,2,0 6,2,0 6,2,0 6,2,0 6,2,0 6,2,0 6,2,0 6,2,0 6,2,0 5,2,4 2,2,4 0,0,4 0,0,4 0,0,4 0,0,4 0,0,4 0,0,4 0,0,4 0,0,4 0,0,4 0,0,4 0,0,4 2,5,4 6,1,0 6,1,0 6,1,0 6,1,0 6,1,0 6,1,0
6,2,0 6,2,0 6,2,0 6,2,0 6,2,0 6,2,0 6,2,0 6,2,0 6,2,0 6,2,0 6,2,0 6,2,0 6,2,0 6,2,0 6,2,0 5,2,4 2,2,4 0,0,4 0,0,4 0,0,4 0,0,4 0,0,4 0,0,4 0,0,4 0,0,4 0,0,4 0,0,4 0,0,4 2,5,4 6,1,0 6,1,0 6,1,0 6,1,0 6,1,0 6,1,0
6,2,0 6,2,0 6,2,0 6,2,0 6,2,0 6,2,0 6,2,0 6,2,0 6,2,0 6,2,0 6,2,0 6,2,0 6,2,0 6,2,0 6,2,0 5,2,3 2,2,3 0,0,3 0,0,3 0,0,3 0,0,3 0,0,3 0,0,3 0,0,3 0,0,3 0,0,3 0,0,3 0,0,3 2,5,3 6,1,0 6,1,0 6,1,0 6,1,0 6,1,0 6,1,0
6,2,0 6,2,0 6,2,0 6,2,0 6,2,0 6,2,0 6,2,0 6,2,0 6,2,0 6,2,0 6,2,0 6,2,0 6,2,0 6,2,0 6,2,0 5,2,4 2,2,4 0,0,4 0,0,4 0,0,4 0,0,4 0,0,4 0,0,4 0,0,4 0,0,4 0,0,4 0,0,4 0,0,4 2,5,4 6,1,0 6,1,0 6,1,0 6,1,0 6,1,0 6,1,0
6,2,0 6,2,0 6,2,0 6,2,0 6,2,0 6,2,0 6,2,0 6,2,0 6,2,0 6,2,0 6,2,0 6,2,0 6,2,0 6,2,0 6,2,0 5,2,4 2,2,4 0,0,4 0,0,4 0,0,4 0,0,4 0,0,4 0,0,4 0,0,4 0,0,4 0,0,4 0,0,4 0,0,4 2,5,4 6,1,0 6,1,0 6,1,0 6,1,0 6,1,0 6,1,0
6,2,0 6,2,0 6,2,0 6,2,0 6,2,0 6,2,0 6,2,0 6,2,0 6,2,0 6,2,0 6,2,0 6,2,0 6,2,0 6,2,0 6,2,0 5,2,4 2,2,4 0,0,4 0,0,4 0,0,4 0,0,4 0,0,4 0,0,4 0,0,4 0,0,4 0,0,4 0,0,4 0,0,4 2,5,4 6,1,0 6,1,0 6,1,0 6,1,0 6,1,0 6,1,0
6,2,0 6,2,0 6,2,0 6,2,0 6,2,0 6,2,0 6,2,0 6,2,0 6,2,0 6,2,0 6,2,0 6,2,0 6,2,0 6,2,0 6,2,0 5,2,4 2,2,4 0,0,4 0,0,4 0,0,4 0,0,4 0,0,4 0,0,4 0,0,4 0,0,4 0,0,4 0,0,4 0,0,4 2,5,4 6,1,0 6,1,0 6,1,0 6,1,0 6,1,0 6,1,0
6,2,0 6,2,0 6,2,0 6,2,0 6,2,0 6,2,0 6,2,0 6,2,0 6,2,0 6,2,0 6,2,0 6,2,0 6,2,0 6,2,0 6,2,0 5,2,4 2,2,4 0,0,4 0,0,4 0,0,4 0,0,4 0,0,4 0,0,4 0,0,4 0,0,4 0,0,4 0,0,4 0,0,4 2,5,4 6,1,0 6,1,0 6,1,0 6,1,0 6,1,0 6,1,0