6,1,0 6,1,0 6,1,0 6,1,0 6,1,0 6,1,0 0,5,4 0,0,4 0,0,4 0,0,4 0,0,4 0,0,4 0,0,4 0,0,4 0,0,4 0,0,4 0,0,4 0,0,4 0,2,4 3,2,4 6,2,0 6,2,0 6,2,0 6,2,0 6,2,0 6,2,0 6,2,0 6,2,0 6,2,0 6,2,0 6,2,0 6,2,0 6,2,0 6,2,0 6,2,0 6,2,0 6,2,0 6,2,0 6,2,0 6,2,0 5,2,4 2,2,4 0,0,4 0,0,4 0,0,4 0,0,4 0,0,4 0,0,4 0,0,4 0,0,4 0,0,4 0,0,4 0,0,4 2,5,4 6,1,0 6,1,0 6,1,0 6,1,0 6,1,0 6,1,0
6,1,0 6,1,0 6,1,0 6,1,0 6,1,0 6,1,0 0,5,4 0,0,4 0,0,4 0,0,4 0,0,4 0,0,4 0,0,4 0,0,4 0,0,4 0,0,4 0,0,4 0,0,4 0,2,4 3,2,4 6,2,0 6,2,0 6,2,0 6,2,0 6,2,0 6,2,0 6,2,0 6,2,0 6,2,0 6,2,0 6,2,0 6,2,0 6,2,0 6,2,0 6,2,0 6,2,0 6,2,0 6,2,0 6,2,0 6,2,0 5,2,4 2,2,4 0,0,4 0,0,4 0,0,4 0,0,4 0,0,4 0,0,4 0,0,4 0,0,4 0,0,4 0,0,4 0,0,4 2,5,4 6,1,0 6,1,0 6,1,0 6,1,0 6,1,0 6,1,0
6,1,0 6,1,0 6,1,0 6,1,0 6,1,0 6,1,0 0,5,4 0,0,4 0,0,4 0,0,4 0,0,4 0,0,4 0,0,4 0,0,4 0,0,4 0,0,4 0,0,4 0,0,4 0,2,4 3,2,4 6,2,0 6,2,0 6,2,0 6,2,0 6,2,0 6,2,0 6,2,0 6,2,0 6,2,0 6,2,0 6,2,0 6,2,0 6,2,0 6,2,0 6,2,0 6,2,0 6,2,0 6,2,0 6,2,0 6,2,0 5,2,4 2,2,4 0,0,4 0,0,4 0,0,4 0,0,4 0,0,4 0,0,4 0,0,4 0,0,4 0,0,4 0,0,4 0,0,4 2,5,4 6,1,0 6,1,0 6,1,0 6,1,0 6,1,0 6,1,0
6,1,0 6,1,0 6,1,0 6,1,0 6,1,0 6,1,0 0,5,4 0,0,4 0,0,4 0,0,4 0,0,4 0,0,4 0,0,4 0,0,4 0,0,4 0,0,4 0,0,4 0,0,4 0,2,4 3,2,4 6,2,0 6,2,0 6,2,0 6,2,0 6,2,0 6,2,0 6,2,0 6,2,0 6,2,0 6,2,0 6,2,0 6,2,0 6,2,0 6,2,0 6,2,0 6,2,0 6,2,0 6,2,0 6,2,0 6,2,0 5,2,4 2,2,4 0,0,4 0,0,4 0,0,4 0,0,4 0,0,4 0,0,4 0,0,4 0,0,4 0,0,4 0,0,4 0,0,4 2,5,4 6,1,0 6,1,0 6,1,0 6,1,0 6,1,0 6,1,0
6,1,0 6,1,0 6,1,0 6,1,0 6,1,0 6,1,0 0,5,4 0,0,4 0,0,4 0,0,4 0,0,4 0,0,4 0,0,4 0,0,4 0,0,4 0,0,4 0,0,4 0,0,4 0,2,4 3,2,4 6,2,0 6,2,0 6,2,0 6,2,0 6,2,0 6,2,0 6,2,0 6,2,0 6,2,0 6,2,0 6,2,0 6,2,0 6,2,0 6,2,0 6,2,0 6,2,0 6,2,0 6,2,0 6,2,0 6,2,0 5,2,4 2,2,4 0,0,4 0,0,4 0,0,4 0,0,4 0,0,4 0,0,4 0,0,4 0,0,4 0,0,4 0,0,4 0,0,4 2,5,4 6,1,0 6,1,0 6,1,0 6,1,0 6,1,0 6,1,0
6,1,0 6,1,0 6,1,0 6,1,0 6,1,0 6,1,0 0,5,1 0,0,1 0,0,1 0,0,1 0,0,1 0,0,1 0,0,1 0,0,1 0,0,1 0,0,1 0,0,1 0,0,1 0,2,1 3,2,1 6,2,0 6,2,0 6,2,0 6,2,0 6,2,0 6,2,0 6,2,0 6,2,0 6,2,0 6,2,0 6,2,0 6,2,0 6,2,0 6,2,0 6,2,0 6,2,0 6,2,0 6,2,0 6,2,0 6,2,0 5,2,2 2,2,2 0,0,2 0,0,2 0,0,2 0,0,2 0,0,2 0,0,2 0,0,2 0,0,2 0,0,2 0,0,2 0,0,2 2,5,2 6,1,0 6,1,0 6,1,0 6,1,0 6,1,0 6,1,0
6,1,0 6,1,0 6,1,0 6,1,0 6,1,0 6,1,0 0,5,4 0,0,4 0,0,4 0,0,4 0,0,4 0,0,4 0,0,4 0,0,4 0,0,4 0,0,4 0,0,4 0,0,4 0,2,4 3,2,4 6,2,0 6,2,0 6,2,0 6,2,0 6,2,0 6,2,0 6,2,0 6,2,0 6,2,0 6,2,0 6,2,0 6,2,0 6,2,0 6,2,0 6,2,0 6,2,0 6,2,0 6,2,0 6,2,0 6,2,0 5,2,4 2,2,4 0,0,4 0,0,4 0,0,4 0,0,4 0,0,4 0,0,4 0,0,4 0,0,4 0,0,4 0,0,4 0,0,4 2,5,4 6,1,0 6,1,0 6,1,0 6,1,0 6,1,0 6,1,0
6,1,0 6,1,0 6,1,0 6,1,0 6,1,0 6,1,0 0,5,4 0,0,4 0,0,4 0,0,4 0,0,4 0,0,4 0,0,4 0,0,4 0,0,4 0,0,4 0,0,4 0,0,4 0,2,4 3,2,4 6,2,0 6,2,0 6,2,0 6,2,0 6,2,0 6,2,0 6,2,0 6,2,0 6,2,0 6,2,0 6,2,0 6,2,0 6,2,0 6,2,0 6,2,0 6,2,0 6,2,0 6,2,0 6,2,0 6,2,0 5,2,4 2,2,4 0,0,4 0,0,4 0,0,4 0,0,4 0,0,4 0,0,4 0,0,4 0,0,4 0,0,4 0,0,4 0,0,4 2,5,4 6,1,0 6,1,0 6,1,0 6,1,0 6,1,0 6,1,0
6,1,0 6,1,0 6,1,0 6,1,0 6,1,0 6,1,0 0,5,4 0,0,4 0,0,4 0,0,4 0,0,4 0,0,4 0,0,4 0,0,4 0,0,4 0,0,4 0,0,4 0,0,4 0,2,4 3,2,4 6,2,0 6,2,0 6,2,0 6,2,0 6,2,0 6,2,0 6,2,0 6,2,0 6,2,0 6,2,0 6,2,0 6,2,0 6,2,0 6,2,0 6,2,0 6,2,0 6,2,0 6,2,0 6,2,0 6,2,0 5,2,4 2,2,4 0,0,4 0,0,4 0,0,4 0,0,4 0,0,4 0,0,4 0,0,4 0,0,4 0,0,4 0,0,4 0,0,4 2,5,4 6,1,0 6,1,0 6,1,0 6,1,0 6,1,0 6,1,0
6,1,0 6,1,0 6,1,0 6,1,0 6,1,0 6,1,0 0,5,4 0,0,4 0,0,4 0,0,4 0,0,4 0,0,4 0,0,4 0,0,4 0,0,4 0,0,4 0,0,4 0,0,4 0,2,4 3,2,4 6,2,0 6,2,0 6,2,0 6,2,0 6,2,0 6,2,0 6,2,0 6,2,0 6,2,0 6,2,0 6,2,0 6,2,0 6,2,0 6,2,0 6,2,0 6,2,0 6,2,0 6,2,0 6,2,0 6,2,0 5,2,4 2,2,4 0,0,4 0,0,4 0,0,4 0,0,4 0,0,4 0,0,4 0,0,4 0,0,4 0,0,4 0,0,4 0,0,4 2,5,4 6,1,0 6,1,0 6,1,0 6,1,0 6,1,0 6,1,0
6,1,0 6,1,0 6,1,0 6,1,0 6,1,0 6,1,0 0,5,4 0,0,4 0,0,4 0,0,4 0,0,4 0,0,4 0,0,4 0,0,4 0,0,4 0,0,4 0,0,4 0,0,4 0,2,4 3,2,4 6,2,0 6,2,0 6,2,0 6,2,0 6,2,0 6,2,0 6,2,0 6,2,0 6,2,0 6,2,0 6,2,0 6,2,0 6,2,0 6,2,0 6,2,0 6,2,0 6,2,0 6,2,0 6,2,0 6,2,0 5,2,4 2,2,4 0,0,4 0,0,4 0,0,4 0,0,4 0,0,4 0,0,4 0,0,4 0,0,4 0,0,4 0,0,4 0,0,4 2,5,4 6,1,0 6,1,0 6,1,0 6,1,0 6,1,0 6,1,0
6,1,0 6,1,0 6,1,0 6,1,0 6,1,0 6,1,0 0,5,4 0,0,4 0,0,4 0,0,4 0,0,4 0,0,4 0,0,4 0,0,4 0,0,4 0,0,4 0,0,4 0,0,4 0,2,4 3,3,4 4,3,4 4,3,4 4,3,4 4,3,4 4,3,4 4,3,4 4,3,4 4,3,4 4,3,4 4,3,4 4,3,4 4,3,4 4,3,4 4,3,4 4,3,4 4,3,4 4,3,4 4,3,4 4,3,4 4,3,4 5,3,4 2,2,4 0,0,4 0,0,4 0,0,4 0,0,4 0,0,4 0,0,4 0,0,4 0,0,4 0,0,4 0,0,4 0,0,4 2,5,4 6,1,0 6,1,0 6,1,0 6,1,0 6,1,0 6,1,0
6,1,0 6,1,0 6,1,0 6,1,0 6,1,0 6,1,0 0,5,4 0,0,4 0,0,4 0,0,4 0,0,4 0,0,4 0,0,4 0,0,4 0,0,4 0,0,4 0,0,4 0,0,4 0,3,4 1,3,4 1,3,4 1,3,4 1,3,4 1,3,4 1,3,4 1,3,4 1,3,4 1,3,4 1,3,4 1,3,4 1,3,4 1,3,4 1,3,4 1,3,4 1,3,4 1,3,4 1,3,4 1,3,4 1,3,4 1,3,4 1,3,4 2,3,4 0,0,4 0,0,4 0,0,4 0,0,4 0,0,4 0,0,4 0,0,4 0,0,4 0,0,4 0,0,4 0,0,4 2,5,4 6,1,0 6,1,0 6,1,0 6,1,0 6,1,0 6,1,0
6,1,0 6,1,0 6,1,0 6,1,0 6,1,0 6,1,0 0,5,4 0,0,4 0,0,4 0,0,4 0,0,4 0,0,4 0,0,4 0,0,4 0,0,4 0,0,4 0,0,4 0,0,4 0,0,4 0,0,4 0,0,4 0,0,4 0,0,4 0,0,4 0,0,4 0,0,4 0,0,4 0,0,4 0,0,4 0,0,4 0,0,4 0,0,4 0,0,4 0,0,4 0,0,4 0,0,4 0,0,4 0,0,4 0,0,4 0,0,4 0,0,4 0,0,4 0,0,4 0,0,4 0,0,4 0,0,4 0,0,4 0,0,4 0,0,4 0,0,4 0,0,4 0,0,4 0,0,4 2,5,4 6,1,0 6,1,0 6,1,0 6,1,0 6,1,0 6,1,0
6,1,0 6,1,0 6,1,0 6,1,0 6,1,0 6,1,0 0,5,4 0,0,4 0,0,4 0,0,4 0,0,4 0,0,4 0,0,4 0,0,4 0,0,4 0,0,4 0,0,4 0,0,4 0,0,4 0,0,4 0,0,4 0,0,4 0,0,4 0,0,4 0,0,4 0,0,4 0,0,4 0,0,4 0,0,4 0,0,4 0,0,4 0,0,4 0,0,4 0,0,4 0,0,4 0,0,4 0,0,4 0,0,4 0,0,4 0,0,4 0,0,4 0,0,4 0,0,4 0,0,4 0,0,4 0,0,4 0,0,4 0,0,4 0,0,4 0,0,4 0,0,4 0,0,4 0,0,4 2,5,4 6,1,0 6,1,0 6,1,0 6,1,0 6,1,0 6,1,0
6,1,0 6,1,0 6,1,0 6,1,0 6,1,0 6,1,0 0,5,4 0,0,4 0,0,4 6,0,5 0,0,4 0,0,4 0,0,4 0,0,4 0,0,4 0,0,4 0,0,4 0,0,4 0,0,4 0,0,4 0,0,4 0,0,4 0,0,4 0,0,4 0,0,4 0,0,4 0,0,4 0,0,4 0,0,4 0,0,4 0,0,4 0,0,4 0,0,4 0,0,4 0,0,4 0,0,4 0,0,4 0,0,4 0,0,4 0,0,4 0,0,4 0,0,4 0,0,4 0,0,4 0,0,4 0,0,4 0,0,4 0,0,4 0,0,4 0,0,4 0,0,4 0,0,4 0,0,4 2,5,4 6,1,0 6,1,0 6,1,0 6,1,0 6,1,0 6,1,0
6,1,0 6,1,0 6,1,0 6,1,0 6,1,0 6,1,0 0,5,4 0,0,4 0,0,4 0,0,4 0,0,4 0,0,4 0,0,4 0,0,4 0,0,4 0,0,4 0,0,4 0,0,4 0,0,4 0,0,4 0,0,4 0,0,4 0,0,4 0,0,4 0,0,4 0,0,4 0,0,4 0,0,4 0,0,4 0,0,4 0,0,4 0,0,4 0,0,4 0,0,4 0,0,4 0,0,4 0,0,4 0,0,4 0,0,4 0,0,4 0,0,4 0,0,4 0,0,4 0,0,4 0,0,4 0,0,4 0,0,4 0,0,4 0,0,4 0,0,4 0,0,4 0,0,4 0,0,4 2,5,4 6,1,0 6,1,0 6,1,0 6,1,0 6,1,0 6,1,0
6,1,0 6,1,0 6,1,0 6,1,0 6,1,0 6,1,0 0,5,4 0,0,4 0,0,4 0,0,4 0,0,4 0,0,4 0,0,4 0,0,4 0,0,4 0,0,4 0,0,4 0,0,4 0,0,4 0,0,4 0,0,4 0,0,4 0,0,4 0,0,4 0,0,4 0,0,4 0,0,4 0,0,4 0,0,4 0,0,4 0,0,4 0,0,4 0,0,4 0,0,4 0,0,4 0,0,4 0,0,4 0,0,4 0,0,4 0,0,4 0,0,4 0,0,4 0,0,4 0,0,4 0,0,4 0,0,4 0,0,4 0,0,4 0,0,4 0,0,4 0,0,4 0,0,4 0,0,4 2,5,4 6,1,0 6,1,0 6,1,0 6,1,0 6,1,0 6,1,0
6,1,0 6,1,0 6,1,0 6,1,0 6,1,0 6,1,0 0,5,4 0,0,4 0,0,4 0,0,4 0,0,4 0,0,4 0,0,4 0,0,4 0,0,4 0,0,4 0,0,4 0,0,4 0,0,4 0,0,4 0,0,4 0,0,4 0,0,4 0,0,4 0,0,4 0,0,4 0,0,4 0,0,4 0,0,4 0,0,4 0,0,4 0,0,4 0,0,4 0,0,4 0,0,4 0,0,4 0,0,4 0,0,4 0,0,4 0,0,4 0,0,4 0,0,4 0,0,4 0,0,4 0,0,4 0,0,4 0,0,4 0,0,4 0,0,4 0,0,4 0,0,4 0,0,4 0,0,4 2,5,4 6,1,0 6,1,0 6,1,0 6,1,0 6,1,0 6,1,0
6,1,0 6,1,0 6,1,0 6,1,0 6,1,0 6,1,0 0,5,4 0,0,4 0,0,4 0,0,4 0,0,4 0,0,4 0,0,4 0,0,4 0,0,4 0,0,4 0,0,4 0,0,4 0,0,4 0,0,4 0,0,4 0,0,4 0,0,4 0,0,4 0,0,4 0,0,4 0,0,4 0,0,4 0,0,4 0,0,4 0,0,4 0,0,4 0,0,4 0,0,4 0,0,4 0,0,4 0,0,4 0,0,4 0,0,4 0,0,4 0,0,4 0,0,4 0,0,4 0,0,4 0,0,4 0,0,4 0,0,4 0,0,4 0,0,4 0,0,4 0,0,4 0,0,4 0,0,4 2,5,4 6,1,0 6,1,0 6,1,0 6,1,0 6,1,0 6,1,0
6,1,0 6,1,0 6,1,0 6,1,0 6,1,0 6,1,0 0,5,4 0,0,4 0,0,4 0,0,4 0,0,4 0,0,4 0,0,4 0,0,4 0,0,4 0,0,4 0,0,4 0,0,4 0,0,4 0,0,4 0,0,4 0,0,4 0,0,4 0,0,4 0,0,4 0,0,4 0,0,4 0,0,4 0,0,4 0,0,4 0,0,4 0,0,4 0,0,4 0,0,4 0,0,4 0,0,4 0,0,4 0,0,4 0,0,4 0,0,4 0,0,4 0,0,4 0,0,4 0,0,4 0,0,4 0,0,4 0,0,4 0,0,4 0,0,4 0,0,4 0,0,4 0,0,4 0,0,4 2,5,4 6,1,0 6,1,0 6,1,0 6,1,0 6,1,0 6,1,0
6,1,0 6,1,0 6,1,0 6,1,0 6,1,0 6,1,0 0,5,4 0,0,4 0,0,4 0,0,4 0,0,4 0,0,4 0,0,4 0,0,4 0,0,4 0,0,4 0,0,4 0,0,4 0,0,4 0,0,4 0,0,4 0,0,4 0,0,4 0,0,4 0,0,4 0,0,4 0,0,4 0,0,4 0,0,4 0,0,4 0,0,4 0,0,4 0,0,4 0,0,4 0,0,4 0,0,4 0,0,4 0,0,4 0,0,4 0,0,4 0,0,4 0,0,4 0,0,4 0,0,4 0,0,4 0,0,4 0,0,4 0,0,4 0,0,4 0,0,4 0,0,4 0,0,4 0,0,4 2,5,4 6,1,0 6,1,0 6,1,0 6,1,0 6,1,0 6,1,0
6,1,0 6,1,0 6,1,0 6,1,0 6,1,0 6,1,0 0,5,4 0,0,4 0,0,4 0,0,4 0,0,4 0,0,4 0,0,4 0,0,4 0,0,4 0,0,4 0,0,4 0,0,4 0,0,4 0,0,4 0,0,4 0,0,4 0,0,4 0,0,4 0,0,4 0,0,4 0,0,4 0,0,4 0,0,4 0,0,4 0,0,4 0,0,4 0,0,4 0,0,4 0,0,4 0,0,4 0,0,4 0,0,4 0,0,4 0,0,4 0,0,4 0,0,4 0,0,4 0,0,4 0,0,4 0,0,4 0,0,4 0,0,4 0,0,4 0,0,4 0,0,4 0,0,4 0,0,4 2,5,4 6,1,0 6,1,0 6,1,0 6,1,0 6,1,0 6,1,0
6,1,0 6,1,0 6,1,0 6,1,0 6,1,0 6,1,0 0,5,4 0,0,4 0,0,4 0,0,4 0,0,4 0,0,4 0,0,4 0,0,4 0,0,4 0,0,4 0,0,4 0,0,4 0,0,4 0,0,4 0,0,4 0,0,4 0,0,4 0,0,4 0,0,4 0,0,4 0,0,4 0,0,4 0,0,4 0,0,4 0,0,4 0,0,4 0,0,4 0,0,4 0,0,4 0,0,4 0,0,4 0,0,4 0,0,4 0,0,4 0,0,4 0,0,4 0,0,4 0,0,4 0,0,4 0,0,4 0,0,4 0,0,4 0,0,4 0,0,4 0,0,4 0,0,4 0,0,4 2,5,4 6,1,0 6,1,0 6,1,0 6,1,0 6,1,0 6,1,0
6,1,0 6,1,0 6,1,0 6,1,0 6,1,0 6,1,0 0,5,4 0,0,4 0,0,4 0,0,4 0,0,4 0,0,4 0,0,4 0,0,4 0,0,4 0,0,4 0,0,4 0,0,4 0,0,4 0,0,4 0,0,4 0,0,4 0,0,4 0,0,4 0,0,4 0,0,4 0,0,4 0,0,4 0,0,4 0,0,4 0,0,4 0,0,4 0,0,4 0,0,4 0,0,4 0,0,4 0,0,4 0,0,4 0,0,4 0,0,4 0,0,4 0,0,4 0,0,4 0,0,4 0,0,4 0,0,4 0,0,4 0,0,4 0,0,4 0,0,4 0,0,4 0,0,4 0,0,4 2,5,4 6,1,0 6,1,0 6,1,0 6,1,0 6,1,0 6,1,0
6,1,0 6,1,0 6,1,0 6,1,0 6,1,0 6,1,0 0,5,4 0,0,4 0,0,4 0,0,4 0,0,4 0,0,4 0,0,4 0,0,4 0,0,4 0,0,4 0,0,4 0,0,4 0,0,4 0,0,4 0,0,4 0,0,4 0,0,4 0,0,4 0,0,4 0,0,4 0,0,4 0,0,4 0,0,4 0,0,4 0,0,4 0,0,4 0,0,4 0,0,4 0,0,4 0,0,4 0,0,4 0,0,4 0,0,4 0,0,4 0,0,4 0,0,4 0,0,4 0,0,4 0,0,4 0,0,4 0,0,4 0,0,4 0,0,4 0,0,4 0,0,4 0,0,4 0,0,4 2,5,4 6,1,0 6,1,0 6,1,0 6,1,0 6,1,0 6,1,0
6,1,0 6,1,0 6,1,0 6,1,0 6,1,0 6,1,0 0,5,4 0,0,4 0,0,4 0,0,4 0,0,4 0,0,4 0,0,4 0,0,4 0,0,4 0,0,4 0,0,4 0,0,4 0,0,4 0,0,4 0,0,4 0,0,4 0,0,4 0,0,4 0,0,4 0,0,4 0,0,4 0,0,4 0,0,4 0,0,4 0,0,4 0,0,4 0,0,4 0,0,4 0,0,4 0,0,4 0,0,4 0,0,4 0,0,4 0,0,4 0,0,4 0,0,4 0,0,4 0,0,4 0,0,4 0,0,4 0,0,4 0,0,4 0,0,4 0,0,4 0,0,4 0,0,4 0,0,4 2,5,4 6,1,0 6,1,0 6,1,0 6,1,0 6,1,0 6,1,0
6,1,0 6,1,0 6,1,0 6,1,0 6,1,0 6,1,0 0,5,4 0,0,4 0,0,4 0,0,4 0,0,4 0,0,4 0,0,4 0,0,4 0,0,4 0,0,4 0,0,4 0,0,4 0,0,4 0,0,4 0,0,4 0,0,4 0,0,4 0,0,4 0,0,4 0,0,4 0,0,4 0,0,4 0,0,4 0,0,4 0,0,4 0,0,4 0,0,4 0,0,4 0,0,4 0,0,4 0,0,4 0,0,4 0,0,4 0,0,4 0,0,4 0,0,4 0,0,4 0,0,4 0,0,4 0,0,4 0,0,4 0,0,4 0,0,4 0,0,4 0,0,4 0,0,4 0,0,4 2,5,4 6,1,0 6,1,0 6,1,0 6,1,0 6,1,0 6,1,0
6,1,0 6,1,0 6,1,0 6,1,0 6,1,0 6,1,0 0,6,4 1,6,4 1,6,4 1,6,4 1,6,4 1,6,4 1,6,4 1,6,4 1,6,4 1,6,4 1,6,4 1,6,4 1,6,4 1,6,4 1,6,4 1,6,4 1,6,4 1,6,4 1,6,4 1,6,4 1,6,4 1,6,4 1,6,4 1,6,4 1,6,4 1,6,4 1,6,4 1,6,4 1,6,4 1,6,4 1,6,4 1,6,4 1,6,4 1,6,4 1,6,4 1,6,4 1,6,4 1,6,4 1,6,4 1,6,4 1,6,4 1,6,4 1,6,4 1,6,4 1,6,4 1,6,4 1,6,4 2,6,4 6,1,0 6,1,0 6,1,0 6,1,0 6,1,0 6,1,0
6,1,0 6,1,0 6,1,0 6,1,0 6,1,0 6,1,0 6,1,0 6,1,0 6,1,0 6,1,0 6,1,0 6,1,0 6,1,0 6,1,0 6,1,0 6,1,0 6,1,0 6,1,0 6,1,0 6,1,0 6,1,0 6,1,0 6,1,0 6,1,0 6,1,0 6,1,0 6,1,0 6,1,0 6,1,0 6,1,0 6,1,0 6,1,0 6,1,0 6,1,0 6,1,0 6,1,0 6,1,0 6,1,0 6,1,0 6,1,0 6,1,0 6,1,0 6,1,0 6,1,0 6,1,0 6,1,0 6,1,0 6,1,0 6,1,0 6,1,0 6,1,0 6,1,0 6,1,0 6,1,0 6,1,0 6,1,0 6,1,0 6,1,0 6,1,0 6,1,0
6,1,0 6,1,0 6,1,0 6,1,0 6,1,0 6,1,0 6,1,0 6,1,0 6,1,0 6,1,0 6,1,0 6,1,0 6,1,0 6,1,0 6,1,0 6,1,0 6,1,0 6,1,0 6,1,0 6,1,0 6,1,0 6,1,0 6,1,0 6,1,0 6,1,0 6,1,0 6,1,0 6,1,0 6,1,0 6,1,0 6,1,0 6,1,0 6,1,0 6,1,0 6,1,0 6,1,0 6,1,0 6,1,0 6,1,0 6,1,0 6,1,0 6,1,0 6,1,0 6,1,0 6,1,0 6,1,0 6,1,0 6,1,0 6,1,0 6,1,0 6,1,0 6,1,0 6,1,0 6,1,0 6,1,0 6,1,0 6,1,0 6,1,0 6,1,0 6,1,0
6,1,0 6,1,0 6,1,0 6,1,0 6,1,0 6,1,0 6,1,0 6,1,0 6,1,0 6,1,0 6,1,0 6,1,0 6,1,0 6,1,0 6,1,0 6,1,0 6,1,0 6,1,0 6,1,0 6,1,0 6,1,0 6,1,0 6,1,0 6,1,0 6,1,0 6,1,0 6,1,0 6,1,0 6,1,0 6,1,0 6,1,0 6,1,0 6,1,0 6,1,0 6,1,0 6,1,0 6,1,0 6,1,0 6,1,0 6,1,0 6,1,0 6,1,0 6,1,0 6,1,0 6,1,0 6,1,0 6,1,0 6,1,0 6,1,0 6,1,0 6,1,0 6,1,0 6,1,0 6,1,0 6,1,0 6,1,0 6,1,0 6,1,0 6,1,0 6,1,0
6,1,0 6,1,0 6,1,0 6,1,0 6,1,0 6,1,0 6,1,0 6,1,0 6,1,0 6,1,0 6,1,0 6,1,0 6,1,0 6,1,0 6,1,0 6,1,0 6,1,0 6,1,0 6,1,0 6,1,0 6,1,0 6,1,0 6,1,0 6,1,0 6,1,0 6,1,0 6,1,0 6,1,0 6,1,0 6,1,0 6,1,0 6,1,0 6,1,0 6,1,0 6,1,0 6,1,0 6,1,0 6,1,0 6,1,0 6,1,0 6,1,0 6,1,0 6,1,0 6,1,0 6,1,0 6,1,0 6,1,0 6,1,0 6,1,0 6,1,0 6,1,0 6,1,0 6,1,0 6,1,0 6,1,0 6,1,0 6,1,0 6,1,0 6,1,0 6,1,0
6,1,0 6,1,0 6,1,0 6,1,0 6,1,0 6,1,0 6,1,0 6,1,0 6,1,0 6,1,0 6,1,0 6,1,0 6,1,0 6,1,0 6,1,0 6,1,0 6,1,0 6,1,0 6,1,0 6,1,0 6,1,0 6,1,0 6,1,0 6,1,0 6,1,0 6,1,0 6,1,0 6,1,0 6,1,0 6,1,0 6,1,0 6,1,0 6,1,0 6,1,0 6,1,0 6,1,0 6,1,0 6,1,0 6,1,0 6,1,0 6,1,0 6,1,0 6,1,0 6,1,0 6,1,0 6,1,0 6,1,0 6,1,0 6,1,0 6,1,0 6,1,0 6,1,0 6,1,0 6,1,0 6,1,0 6,1,0 6,1,0 6,1,0 6,1,0 6,1,0
6,1,0 6,1,0 6,1,0 6,1,0 6,1,0 6,1,0 6,1,0 6,1,0 6,1,0 6,1,0 6,1,0 6,1,0 6,1,0 6,1,0 6,1,0 6,1,0 6,1,0 6,1,0 6,1,0 6,1,0 6,1,0 6,1,0 6,1,0 6,1,0 6,1,0 6,1,0 6,1,0 6,1,0 6,1,0 6,1,0 6,1,0 6,1,0 6,1,0 6,1,0 6,1,0 6,1,0 6,1,0 6,1,0 6,1,0 6,1,0 6,1,0 6,1,0 6,1,0 6,1,0 6,1,0 6,1,0 6,1,0 6,1,0 6,1,0 6,1,0 6,1,0 6,1,0 6,1,0 6,1,0 6,1,0 6,1,0 6,1,0 6,1,0 6,1,0 6,1,0