06,01,00 06,01,00 06,01,00 06,01,00 06,01,00 06,01,00 06,01,00 00,05,00 03,00,00 00,00,04 00,00,04 03,06,04 00,00,04 00,00,04 00,00,04 00,00,04 00,00,04 00,00,04 00,00,04 00,00,04 00,00,04 00,00,04 00,00,04 00,00,04 00,00,04 00,00,04 00,00,04 00,00,04 00,00,04 00,00,04 06,02,00 06,02,00 00,00,04 00,00,04 00,00,04 00,00,04 00,00,04 00,00,04 00,00,04 00,00,04 00,00,04 00,00,04 00,00,04 00,00,04 00,00,04 00,00,04 00,00,04 00,00,04 00,00,04 00,00,04 00,00,04 00,00,04 00,00,04 00,00,04 02,05,04 06,01,00 06,01,00 06,01,00 06,01,00 06,01,00 06,01,00 06,01,00
06,01,00 06,01,00 06,01,00 06,01,00 06,01,00 06,01,00 06,01,00 00,05,00 03,00,00 00,00,04 00,00,04 03,06,04 00,00,04 00,00,04 00,00,04 00,00,04 00,00,04 00,00,04 00,00,04 00,01,04 01,01,04 01,01,04 01,01,04 01,01,04 01,01,04 01,01,04 01,01,04 01,01,04 01,01,04 01,01,04 06,02,00 06,02,00 01,01,04 01,01,04 01,01,04 01,01,04 01,01,04 01,01,04 01,01,04 01,01,04 01,01,04 01,01,04 02,01,04 00,00,04 00,00,04 00,00,04 00,00,04 00,00,04 00,00,04 00,00,04 00,00,04 00,00,04 00,00,04 00,00,04 02,05,04 06,01,00 06,01,00 06,01,00 06,01,00 06,01,00 06,01,00 06,01,00
06,01,00 06,01,00 06,01,00 06,01,00 06,01,00 06,01,00 06,01,00 00,05,00 03,00,00 03,00,00 00,00,04 03,06,04 00,00,04 00,00,04 00,00,04 00,00,04 00,00,04 00,00,04 00,00,04 00,02,04 03,01,04 04,01,04 04,01,04 04,01,04 04,01,04 04,01,04 04,01,04 04,01,04 04,01,04 04,01,04 06,02,00 06,02,00 04,01,04 04,01,04 04,01,04 04,01,04 04,01,04 04,01,04 04,01,04 04,01,04 04,01,04 05,01,04 02,02,04 00,00,04 00,00,04 00,00,04 00,00,04 00,00,04 00,00,04 00,00,04 00,00,04 00,00,04 00,00,04 00,00,04 02,05,04 06,01,00 06,01,00 06,01,00 06,01,00 06,01,00 06,01,00 06,01,00
06,01,00 06,01,00 06,01,00 06,01,00 06,01,00 06,01,00 06,01,00 00,05,00 03,00,00 03,00,00 00,00,04 03,06,04 00,00,04 00,00,04 00,00,04 00,00,04 00,00,04 00,00,04 00,00,04 00,02,04 03,02,04 06,02,00 06,02,00 06,02,00 06,02,00 06,02,00 06,02,00 06,02,00 06,02,00 06,02,00 06,02,00 06,02,00 06,02,00 06,02,00 06,02,00 06,02,00 06,02,00 06,02,00 06,02,00 06,02,00 06,02,00 05,02,04 02,02,04 00,00,04 00,00,04 00,00,04 00,00,04 00,00,04 00,00,04 00,00,04 00,00,04 00,00,04 00,00,04 00,00,04 02,05,04 06,01,00 06,01,00 06,01,00 06,01,00 06,01,00 06,01,00 06,01,00
06,01,00 06,01,00 06,01,00 06,01,00 06,01,00 06,01,00 06,01,00 00,05,00 03,00,00 03,00,00 03,00,00 03,06,04 00,00,04 00,00,04 00,00,04 00,00,04 00,00,04 00,00,04 00,00,04 00,02,04 03,02,04 06,02,00 06,02,00 06,02,00 06,02,00 06,02,00 06,02,00 06,02,00 06,02,00 06,02,00 06,02,00 06,02,00 06,02,00 06,02,00 06,02,00 06,02,00 06,02,00 06,02,00 06,02,00 06,02,00 06,02,00 05,02,04 02,02,04 00,00,04 00,00,04 00,00,04 00,00,04 00,00,04 00,00,04 00,00,04 00,00,04 00,00,04 00,00,04 00,00,04 02,05,04 06,01,00 06,01,00 06,01,00 06,01,00 06,01,00 06,01,00 06,01,00
06,01,00 06,01,00 06,01,00 06,01,00 06,01,00 06,01,00 06,01,00 00,05,00 03,00,00 03,00,00 03,00,00 03,06,04 03,00,00 03,00,00 03,00,00 03,00,00 00,00,04 00,00,04 00,00,04 00,02,04 03,02,04 06,02,00 06,02,00 06,02,00 06,02,00 06,02,00 06,02,00 06,02,00 06,02,00 06,02,00 06,02,00 06,02,00 06,02,00 06,02,00 06,02,00 06,02,00 06,02,00 06,02,00 06,02,00 06,02,00 06,02,00 05,02,04 02,02,04 00,00,04 00,00,04 00,00,04 00,00,04 00,00,04 00,00,04 00,00,04 00,00,04 00,00,04 00,00,04 00,00,04 02,05,04 06,01,00 06,01,00 06,01,00 06,01,00 06,01,00 06,01,00 06,01,00
06,01,00 06,01,00 06,01,00 06,01,00 06,01,00 06,01,00 06,01,00 00,05,00 03,00,00 03,00,00 03,00,00 03,06,01 03,00,00 03,00,00 03,00,00 03,00,00 03,00,00 00,00,01 00,00,01 00,02,01 03,02,01 06,02,00 06,02,00 06,02,00 06,02,00 06,02,00 06,02,00 06,02,00 06,02,00 06,02,00 06,02,00 06,02,00 06,02,00 06,02,00 06,02,00 06,02,00 06,02,00 06,02,00 06,02,00 06,02,00 06,02,00 05,02,02 02,02,02 00,00,02 00,00,02 00,00,02 00,00,02 00,00,02 00,00,02 00,00,02 00,00,02 00,00,02 00,00,02 00,00,02 02,05,02 06,01,00 06,01,00 06,01,00 06,01,00 06,01,00 06,01,00 06,01,00
06,01,00 06,01,00 06,01,00 06,01,00 06,01,00 06,01,00 06,01,00 00,05,00 03,00,00 03,00,00 03,00,00 03,06,04 03,00,00 03,00,00 03,00,00 03,00,00 03,00,00 03,00,00 00,00,04 00,02,04 03,02,04 06,02,00 06,02,00 06,02,00 06,02,00 06,02,00 06,02,00 06,02,00 06,02,00 06,02,00 06,02,00 06,02,00 06,02,00 06,02,00 06,02,00 06,02,00 06,02,00 06,02,00 06,02,00 06,02,00 06,02,00 05,02,04 02,02,04 00,00,04 00,00,04 00,00,04 00,00,04 00,00,04 00,00,04 00,00,04 00,00,04 00,00,04 00,00,04 00,00,04 02,05,00 06,01,00 06,01,00 06,01,00 06,01,00 06,01,00 06,01,00 06,01,00
06,01,00 06,01,00 06,01,00 06,01,00 06,01,00 06,01,00 06,01,00 00,05,00 03,00,00 03,00,00 03,00,00 03,06,04 03,00,00 03,00,00 03,00,00 03,00,00 03,00,00 03,00,00 00,00,04 00,02,04 03,02,04 06,02,00 06,02,00 06,02,00 06,02,00 06,02,00 06,02,00 06,02,00 06,02,00 06,02,00 06,02,00 06,02,00 06,02,00 06,02,00 06,02,00 06,02,00 06,02,00 06,02,00 06,02,00 06,02,00 06,02,00 05,02,04 02,02,04 00,00,04 00,00,04 00,00,04 00,00,04 00,00,04 00,00,04 00,00,04 00,00,04 00,00,04 00,00,04 00,00,04 02,05,00 06,01,00 06,01,00 06,01,00 06,01,00 06,01,00 06,01,00 06,01,00
06,01,00 06,01,00 06,01,00 06,01,00 06,01,00 06,01,00 06,01,00 00,05,00 03,00,00 03,00,00 03,00,00 03,06,04 03,00,00 03,00,00 03,00,00 03,00,00 03,00,00 03,00,00 00,00,04 00,02,04 03,02,04 06,02,00 06,02,00 06,02,00 06,02,00 06,02,00 06,02,00 06,02,00 06,02,00 06,02,00 06,02,00 06,02,00 06,02,00 06,02,00 06,02,00 06,02,00 06,02,00 06,02,00 06,02,00 06,02,00 06,02,00 05,02,04 02,02,04 00,00,04 00,00,04 00,00,04 00,00,04 00,00,04 00,00,04 00,00,04 00,00,04 00,00,04 00,00,04 00,00,04 02,05,00 06,01,00 06,01,00 06,01,00 06,01,00 06,01,00 06,01,00 06,01,00
06,01,00 06,01,00 06,01,00 06,01,00 06,01,00 06,01,00 06,01,00 00,05,00 03,00,00 03,00,00 03,00,00 03,06,04 12,03,00 03,00,00 03,00,00 03,00,00 03,00,00 03,00,00 03,00,00 00,02,04 03,02,04 06,02,00 06,02,00 06,02,00 06,02,00 06,02,00 06,02,00 06,02,00 06,02,00 06,02,00 06,02,00 06,02,00 06,02,00 06,02,00 06,02,00 06,02,00 06,02,00 06,02,00 06,02,00 06,02,00 06,02,00 05,02,04 02,02,04 00,00,04 00,00,04 00,00,04 00,00,04 00,00,04 00,00,04 00,00,04 00,00,04 00,00,04 00,00,04 00,00,04 02,05,00 06,01,00 06,01,00 06,01,00 06,01,00 06,01,00 06,01,00 06,01,00
06,01,00 06,01,00 06,01,00 06,01,00 06,01,00 06,01,00 06,01,00 00,05,00 03,00,00 03,00,00 03,00,00 03,06,04 07,02,00 03,00,00 03,00,00 03,00,00 03,00,00 03,00,00 03,00,00 00,02,04 03,02,04 06,02,00 06,02,00 06,02,00 06,02,00 06,02,00 06,02,00 06,02,00 06,02,00 06,02,00 06,02,00 06,02,00 06,02,00 06,02,00 06,02,00 06,02,00 06,02,00 06,02,00 06,02,00 06,02,00 06,02,00 05,02,04 02,02,04 00,00,04 00,00,04 00,00,04 00,00,04 00,00,04 00,00,04 00,00,04 00,00,04 00,00,04 00,00,04 00,00,04 02,05,00 06,01,00 06,01,00 06,01,00 06,01,00 06,01,00 06,01,00 06,01,00
06,01,00 06,01,00 06,01,00 06,01,00 06,01,00 06,01,00 06,01,00 00,05,00 03,00,00 03,00,00 07,00,05 03,06,04 07,02,00 00,00,04 03,00,00 03,00,00 03,00,00 03,00,00 03,00,00 00,02,04 03,02,04 06,02,00 06,02,00 06,02,00 06,02,00 06,02,00 06,02,00 06,02,00 06,02,00 06,02,00 06,02,00 06,02,00 06,02,00 06,02,00 06,02,00 06,02,00 06,02,00 06,02,00 06,02,00 06,02,00 06,02,00 05,02,04 02,02,04 00,00,04 00,00,04 00,00,04 00,00,04 00,00,04 00,00,04 00,00,04 00,00,04 00,00,04 00,00,04 00,00,04 02,05,00 06,01,00 06,01,00 06,01,00 06,01,00 06,01,00 06,01,00 06,01,00
06,01,00 06,01,00 06,01,00 06,01,00 06,01,00 06,01,00 06,01,00 00,05,00 03,00,00 03,00,00 07,00,05 03,06,04 07,02,00 00,00,04 03,00,00 03,00,00 03,00,00 03,00,00 00,00,04 00,02,04 03,03,04 04,03,04 04,03,04 04,03,04 04,03,04 04,03,04 04,03,04 04,03,04 04,03,04 04,03,04 04,03,04 04,03,04 04,03,04 04,03,04 04,03,04 04,03,04 04,03,04 04,03,04 04,03,04 04,03,04 04,03,04 05,03,04 02,02,04 00,00,04 00,00,04 00,00,04 00,00,04 00,00,04 00,00,04 00,00,04 00,00,04 00,00,04 00,00,04 00,00,04 02,05,00 06,01,00 06,01,00 06,01,00 06,01,00 06,01,00 06,01,00 06,01,00
06,01,00 06,01,00 06,01,00 06,01,00 06,01,00 06,01,00 06,01,00 00,05,00 03,00,00 07,00,05 07,00,05 03,06,04 07,02,00 00,00,04 00,00,04 00,00,04 00,00,04 00,00,04 00,00,04 00,03,04 01,03,04 01,03,04 01,03,04 01,03,04 01,03,04 01,03,04 01,03,04 01,03,04 01,03,04 01,03,04 01,03,04 01,03,04 01,03,04 01,03,04 01,03,04 01,03,04 01,03,04 01,03,04 01,03,04 01,03,04 01,03,04 01,03,04 02,03,04 00,00,04 00,00,04 00,00,04 00,00,04 00,00,04 00,00,04 00,00,04 00,00,04 00,00,04 00,00,04 00,00,04 02,05,00 06,01,00 06,01,00 06,01,00 06,01,00 06,01,00 06,01,00 06,01,00
06,01,00 06,01,00 06,01,00 06,01,00 06,01,00 06,01,00 06,01,00 00,05,00 03,00,00 07,00,05 07,00,05 03,06,04 07,02,00 00,00,04 00,00,04 00,00,04 00,00,04 00,00,04 00,00,04 00,00,04 00,00,04 00,00,04 00,00,04 00,00,04 00,00,04 00,00,04 00,00,04 00,00,04 00,00,04 00,00,04 00,00,04 00,00,04 00,00,04 00,00,04 00,00,04 00,00,04 00,00,04 00,00,04 00,00,04 00,00,04 00,00,04 00,00,04 00,00,04 00,00,04 00,00,04 00,00,04 00,00,04 00,00,04 00,00,04 00,00,04 00,00,04 00,00,04 00,00,04 00,00,04 02,05,00 06,01,00 06,01,00 06,01,00 06,01,00 06,01,00 06,01,00 06,01,00
06,01,00 06,01,00 06,01,00 06,01,00 06,01,00 06,01,00 06,01,00 00,05,00 03,00,00 07,00,05 07,00,05 03,06,04 07,02,00 00,00,04 00,00,04 00,09,00 01,09,00 02,09,00 03,09,00 04,09,00 10,02,00 08,01,00 08,01,00 08,01,00 08,01,00 08,01,00 09,01,00 05,06,04 12,03,00 00,09,00 01,09,00 02,09,00 03,09,00 04,09,00 10,02,00 08,01,00 08,01,00 08,01,00 08,01,00 08,01,00 09,01,00 05,06,04 12,03,00 05,09,00 06,09,00 07,09,00 08,09,00 09,09,00 12,02,00 05,06,04 00,00,04 00,00,04 00,00,04 00,00,04 02,05,00 06,01,00 06,01,00 06,01,00 06,01,00 06,01,00 06,01,00 06,01,00
06,01,00 06,01,00 06,01,00 06,01,00 06,01,00 06,01,00 06,01,00 00,05,00 03,00,00 07,00,05 07,00,05 03,06,04 07,02,00 00,00,04 00,00,04 00,10,00 01,10,00 02,10,00 03,10,00 04,10,00 00,00,04 14,20,00 15,20,00 16,20,00 17,20,00 03,00,04 09,02,00 05,06,04 07,02,00 00,10,00 01,10,00 02,10,00 03,10,00 04,10,00 00,00,04 10,10,00 11,10,00 12,10,00 13,10,00 14,10,00 09,02,00 05,06,04 07,02,00 05,10,00 06,10,00 07,10,00 08,10,00 09,10,00 09,02,00 05,06,04 00,00,04 00,00,04 00,00,04 00,00,04 02,05,00 06,01,00 06,01,00 06,01,00 06,01,00 06,01,00 06,01,00 06,01,00
06,01,00 06,01,00 06,01,00 06,01,00 06,01,00 06,01,00 06,01,00 00,05,00 03,00,00 07,00,05 07,00,05 03,06,04 07,02,00 00,00,04 00,00,04 00,11,00 01,11,00 02,11,00 03,11,00 04,11,00 00,00,04 14,21,00 15,21,00 16,21,00 17,21,00 03,00,04 09,02,00 05,06,04 07,02,00 00,11,00 01,11,00 02,11,00 03,11,00 04,11,00 00,00,04 10,11,00 11,11,00 12,11,00 13,11,00 14,11,00 09,02,00 05,06,04 07,02,00 05,11,00 06,11,00 07,11,00 08,11,00 09,11,00 09,02,00 05,06,04 00,00,04 00,00,04 00,00,04 00,00,04 02,05,00 06,01,00 06,01,00 06,01,00 06,01,00 06,01,00 06,01,00 06,01,00
06,01,00 06,01,00 06,01,00 06,01,00 06,01,00 06,01,00 06,01,00 00,05,00 03,00,00 07,00,05 07,00,05 03,06,04 07,02,00 00,00,04 00,00,04 00,12,00 01,12,00 02,12,00 03,12,00 04,12,00 00,00,04 14,22,00 15,22,00 16,22,00 17,22,00 03,00,04 09,02,00 05,06,04 07,02,00 00,12,00 01,12,00 02,12,00 03,12,00 04,12,00 00,00,04 10,12,00 11,12,00 12,12,00 13,12,00 14,12,00 09,02,00 05,06,04 07,02,00 05,12,00 06,12,00 07,12,00 08,12,00 09,12,00 09,02,00 05,06,04 00,00,04 00,00,04 00,00,04 00,00,04 02,05,00 06,01,00 06,01,00 06,01,00 06,01,00 06,01,00 06,01,00 06,01,00
06,01,00 06,01,00 06,01,00 06,01,00 06,01,00 06,01,00 06,01,00 00,05,00 03,00,00 07,00,05 07,00,05 03,06,04 07,03,00 08,03,00 10,03,00 08,13,00 01,13,00 02,13,00 03,13,00 04,13,00 03,00,00 14,23,00 15,23,00 16,23,00 17,23,00 10,02,00 09,03,00 05,06,04 11,03,00 08,13,00 01,13,00 02,13,00 03,13,00 04,13,00 00,00,04 10,13,00 11,13,00 12,13,00 13,13,00 14,13,00 11,02,00 05,06,04 11,03,00 05,13,00 06,13,00 07,13,00 08,13,00 09,13,00 11,02,00 05,06,04 00,00,04 00,00,04 00,00,04 00,00,04 02,05,00 06,01,00 06,01,00 06,01,00 06,01,00 06,01,00 06,01,00 06,01,00
06,01,00 06,01,00 06,01,00 06,01,00 06,01,00 06,01,00 06,01,00 00,05,00 03,00,00 07,00,05 07,00,05 03,07,04 04,07,04 04,07,04 04,07,04 04,07,04 04,07,04 04,07,04 04,07,04 04,07,04 04,07,04 04,07,04 04,07,04 04,07,04 04,07,04 04,07,04 04,07,04 06,07,04 04,07,04 04,07,04 04,07,04 04,07,04 04,07,04 04,07,04 04,07,04 04,07,04 04,07,04 04,07,04 04,07,04 04,07,04 04,07,04 06,07,04 04,07,04 04,07,04 04,07,04 04,07,04 04,07,04 04,07,04 04,07,04 05,07,04 00,00,04 00,00,04 00,00,04 00,00,04 02,05,00 06,01,00 06,01,00 06,01,00 06,01,00 06,01,00 06,01,00 06,01,00
06,01,00 06,01,00 06,01,00 06,01,00 06,01,00 06,01,00 06,01,00 00,05,00 03,00,00 07,00,05 07,00,05 03,08,04 04,08,04 04,08,04 04,08,04 04,08,04 04,08,04 06,04,04 04,08,04 04,08,04 04,08,04 04,08,04 04,08,04 04,08,04 04,08,04 04,08,04 04,08,04 04,08,04 04,08,04 06,04,04 04,08,04 04,08,04 04,08,04 04,08,04 04,08,04 04,08,04 04,08,04 04,08,04 04,08,04 04,08,04 04,08,04 04,08,04 04,08,04 04,08,04 04,08,04 04,08,04 04,08,04 06,04,04 04,08,04 05,08,04 00,00,04 00,00,04 00,00,04 00,00,04 02,05,00 06,01,00 06,01,00 06,01,00 06,01,00 06,01,00 06,01,00 06,01,00
06,01,00 06,01,00 06,01,00 06,01,00 06,01,00 06,01,00 06,01,00 00,05,00 07,00,05 07,00,05 07,00,05 10,02,00 08,01,00 08,01,00 08,01,00 08,01,00 09,01,00 03,06,04 05,09,00 06,09,00 07,09,00 08,09,00 09,09,00 00,00,04 00,00,04 00,00,04 00,00,04 00,00,04 00,00,04 05,06,04 09,19,00 10,19,00 11,19,00 12,19,00 13,19,00 00,00,04 00,09,00 01,09,00 02,09,00 03,09,00 04,09,00 00,00,04 00,00,04 00,00,04 00,00,04 00,00,04 00,00,04 05,06,04 07,01,00 08,01,00 08,01,00 08,01,00 08,01,00 10,03,00 02,05,00 06,01,00 06,01,00 06,01,00 06,01,00 06,01,00 06,01,00 06,01,00
06,01,00 06,01,00 06,01,00 06,01,00 06,01,00 06,01,00 06,01,00 00,05,00 07,00,05 07,00,05 07,00,05 07,00,05 07,00,05 07,00,05 07,00,05 07,00,05 09,02,00 03,06,04 05,10,00 06,10,00 07,10,00 08,10,00 09,10,00 00,00,04 10,10,00 11,10,00 12,10,00 13,10,00 14,10,00 05,06,04 09,20,00 10,20,00 11,20,00 12,20,00 13,20,00 00,00,04 00,10,00 01,10,00 02,10,00 03,10,00 04,10,00 00,00,04 10,10,00 11,10,00 12,10,00 13,10,00 14,10,00 05,06,04 07,02,00 04,00,00 05,00,00 05,00,00 05,00,00 06,00,00 02,05,00 06,01,00 06,01,00 06,01,00 06,01,00 06,01,00 06,01,00 06,01,00
06,01,00 06,01,00 06,01,00 06,01,00 06,01,00 06,01,00 06,01,00 00,05,00 07,00,05 07,00,05 07,00,05 07,00,05 07,00,05 07,00,05 07,00,05 07,00,05 09,02,00 03,06,04 05,11,00 06,11,00 07,11,00 08,11,00 09,11,00 00,00,04 10,11,00 11,11,00 12,11,00 13,11,00 14,11,00 05,06,04 09,21,00 10,21,00 11,21,00 12,21,00 13,21,00 00,00,04 00,11,00 01,11,00 02,11,00 03,11,00 04,11,00 00,00,04 10,11,00 11,11,00 12,11,00 13,11,00 14,11,00 05,06,04 11,03,00 07,00,05 07,00,05 07,00,05 07,00,05 07,00,05 02,05,00 06,01,00 06,01,00 06,01,00 06,01,00 06,01,00 06,01,00 06,01,00
06,01,00 06,01,00 06,01,00 06,01,00 06,01,00 06,01,00 06,01,00 00,05,00 07,00,05 07,00,05 07,00,05 07,00,05 07,00,05 07,00,05 07,00,05 07,00,05 09,02,00 03,06,04 05,12,00 06,12,00 07,12,00 08,12,00 09,12,00 00,00,04 10,12,00 11,12,00 12,12,00 13,12,00 14,12,00 05,06,04 09,22,00 10,22,00 11,22,00 12,22,00 13,22,00 00,00,04 00,12,00 01,12,00 02,12,00 03,12,00 04,12,00 00,00,04 10,12,00 11,12,00 12,12,00 13,12,00 14,12,00 05,06,04 00,00,04 07,00,05 07,00,05 07,00,05 07,00,05 07,00,05 02,05,00 06,01,00 06,01,00 06,01,00 06,01,00 06,01,00 06,01,00 06,01,00
06,01,00 06,01,00 06,01,00 06,01,00 06,01,00 06,01,00 06,01,00 00,05,00 07,00,05 07,00,05 07,00,05 07,00,05 07,00,05 07,00,05 07,00,05 07,00,05 09,02,00 03,06,04 05,13,00 06,13,00 07,13,00 08,13,00 09,13,00 00,00,04 10,13,00 11,13,00 12,13,00 13,13,00 14,13,00 05,06,04 09,23,00 10,23,00 11,23,00 12,23,00 13,23,00 00,00,04 00,13,00 01,13,00 02,13,00 03,13,00 04,13,00 00,00,04 10,13,00 11,13,00 12,13,00 13,13,00 14,13,00 05,06,04 12,03,00 07,00,05 07,00,05 07,00,05 07,00,05 07,00,05 02,05,00 06,01,00 06,01,00 06,01,00 06,01,00 06,01,00 06,01,00 06,01,00
06,01,00 06,01,00 06,01,00 06,01,00 06,01,00 06,01,00 06,01,00 00,05,00 03,00,00 07,00,05 07,00,05 07,00,05 07,00,05 07,00,05 07,00,05 07,00,05 09,02,00 03,07,04 04,07,04 04,07,04 04,07,04 04,07,04 04,07,04 04,07,04 04,07,04 04,07,04 04,07,04 04,07,04 04,07,04 06,07,04 04,07,04 04,07,04 04,07,04 04,07,04 04,07,04 04,07,04 04,07,04 04,07,04 04,07,04 04,07,04 04,07,04 04,07,04 04,07,04 04,07,04 04,07,04 04,07,04 04,07,04 05,07,04 07,02,00 07,00,05 07,00,05 07,00,05 07,00,05 07,00,05 02,05,00 06,01,00 06,01,00 06,01,00 06,01,00 06,01,00 06,01,00 06,01,00
06,01,00 06,01,00 06,01,00 06,01,00 06,01,00 06,01,00 06,01,00 00,05,00 03,00,00 03,00,00 03,00,00 03,00,00 03,00,00 07,00,05 07,00,05 07,00,05 11,02,00 03,08,04 04,08,04 04,08,04 04,08,04 04,08,04 04,08,04 04,08,04 04,08,04 04,08,04 04,08,04 04,08,04 04,08,04 04,08,04 04,08,04 04,08,04 04,08,04 04,08,04 04,08,04 04,08,04 04,08,04 04,08,04 04,08,04 04,08,04 04,08,04 04,08,04 04,08,04 04,08,04 04,08,04 04,08,04 04,08,04 05,08,04 11,03,00 04,00,00 05,00,00 05,00,00 05,00,00 06,00,00 02,05,00 06,01,00 06,01,00 06,01,00 06,01,00 06,01,00 06,01,00 06,01,00
06,01,00 06,01,00 06,01,00 06,01,00 06,01,00 06,01,00 06,01,00 00,06,00 01,06,00 01,06,00 01,06,00 01,06,00 01,06,00 01,06,00 01,06,00 01,06,00 01,06,00 01,06,00 01,06,00 01,06,00 01,06,00 01,06,00 01,06,00 01,06,00 01,06,00 01,06,00 01,06,00 01,06,00 01,06,00 01,06,00 01,06,00 01,06,00 01,06,00 01,06,00 01,06,00 01,06,00 01,06,00 01,06,00 01,06,00 01,06,00 01,06,00 01,06,00 01,06,00 01,06,00 01,06,00 01,06,00 01,06,00 01,06,00 01,06,00 01,06,00 01,06,00 01,06,00 01,06,00 01,06,00 02,06,00 06,01,00 06,01,00 06,01,00 06,01,00 06,01,00 06,01,00 06,01,00
06,01,00 06,01,00 06,01,00 06,01,00 06,01,00 06,01,00 06,01,00 06,01,00 06,01,00 06,01,00 06,01,00 06,01,00 06,01,00 06,01,00 06,01,00 06,01,00 06,01,00 06,01,00 06,01,00 06,01,00 06,01,00 06,01,00 06,01,00 06,01,00 06,01,00 06,01,00 06,01,00 06,01,00 06,01,00 06,01,00 06,01,00 06,01,00 06,01,00 06,01,00 06,01,00 06,01,00 06,01,00 06,01,00 06,01,00 06,01,00 06,01,00 06,01,00 06,01,00 06,01,00 06,01,00 06,01,00 06,01,00 06,01,00 06,01,00 06,01,00 06,01,00 06,01,00 06,01,00 06,01,00 06,01,00 06,01,00 06,01,00 06,01,00 06,01,00 06,01,00 06,01,00 06,01,00
06,01,00 06,01,00 06,01,00 06,01,00 06,01,00 06,01,00 06,01,00 06,01,00 06,01,00 06,01,00 06,01,00 06,01,00 06,01,00 06,01,00 06,01,00 06,01,00 06,01,00 06,01,00 06,01,00 06,01,00 06,01,00 06,01,00 06,01,00 06,01,00 06,01,00 06,01,00 06,01,00 06,01,00 06,01,00 06,01,00 06,01,00 06,01,00 06,01,00 06,01,00 06,01,00 06,01,00 06,01,00 06,01,00 06,01,00 06,01,00 06,01,00 06,01,00 06,01,00 06,01,00 06,01,00 06,01,00 06,01,00 06,01,00 06,01,00 06,01,00 06,01,00 06,01,00 06,01,00 06,01,00 06,01,00 06,01,00 06,01,00 06,01,00 06,01,00 06,01,00 06,01,00 06,01,00
06,01,00 06,01,00 06,01,00 06,01,00 06,01,00 06,01,00 06,01,00 06,01,00 06,01,00 06,01,00 06,01,00 06,01,00 06,01,00 06,01,00 06,01,00 06,01,00 06,01,00 06,01,00 06,01,00 06,01,00 06,01,00 06,01,00 06,01,00 06,01,00 06,01,00 06,01,00 06,01,00 06,01,00 06,01,00 06,01,00 06,01,00 06,01,00 06,01,00 06,01,00 06,01,00 06,01,00 06,01,00 06,01,00 06,01,00 06,01,00 06,01,00 06,01,00 06,01,00 06,01,00 06,01,00 06,01,00 06,01,00 06,01,00 06,01,00 06,01,00 06,01,00 06,01,00 06,01,00 06,01,00 06,01,00 06,01,00 06,01,00 06,01,00 06,01,00 06,01,00 06,01,00 06,01,00
06,01,00 06,01,00 06,01,00 06,01,00 06,01,00 06,01,00 06,01,00 06,01,00 06,01,00 06,01,00 06,01,00 06,01,00 06,01,00 06,01,00 06,01,00 06,01,00 06,01,00 06,01,00 06,01,00 06,01,00 06,01,00 06,01,00 06,01,00 06,01,00 06,01,00 06,01,00 06,01,00 06,01,00 06,01,00 06,01,00 06,01,00 06,01,00 06,01,00 06,01,00 06,01,00 06,01,00 06,01,00 06,01,00 06,01,00 06,01,00 06,01,00 06,01,00 06,01,00 06,01,00 06,01,00 06,01,00 06,01,00 06,01,00 06,01,00 06,01,00 06,01,00 06,01,00 06,01,00 06,01,00 06,01,00 06,01,00 06,01,00 06,01,00 06,01,00 06,01,00 06,01,00 06,01,00
06,01,00 06,01,00 06,01,00 06,01,00 06,01,00 06,01,00 06,01,00 06,01,00 06,01,00 06,01,00 06,01,00 06,01,00 06,01,00 06,01,00 06,01,00 06,01,00 06,01,00 06,01,00 06,01,00 06,01,00 06,01,00 06,01,00 06,01,00 06,01,00 06,01,00 06,01,00 06,01,00 06,01,00 06,01,00 06,01,00 06,01,00 06,01,00 06,01,00 06,01,00 06,01,00 06,01,00 06,01,00 06,01,00 06,01,00 06,01,00 06,01,00 06,01,00 06,01,00 06,01,00 06,01,00 06,01,00 06,01,00 06,01,00 06,01,00 06,01,00 06,01,00 06,01,00 06,01,00 06,01,00 06,01,00 06,01,00 06,01,00 06,01,00 06,01,00 06,01,00 06,01,00 06,01,00
06,01,00 06,01,00 06,01,00 06,01,00 06,01,00 06,01,00 06,01,00 06,01,00 06,01,00 06,01,00 06,01,00 06,01,00 06,01,00 06,01,00 06,01,00 06,01,00 06,01,00 06,01,00 06,01,00 06,01,00 06,01,00 06,01,00 06,01,00 06,01,00 06,01,00 06,01,00 06,01,00 06,01,00 06,01,00 06,01,00 06,01,00 06,01,00 06,01,00 06,01,00 06,01,00 06,01,00 06,01,00 06,01,00 06,01,00 06,01,00 06,01,00 06,01,00 06,01,00 06,01,00 06,01,00 06,01,00 06,01,00 06,01,00 06,01,00 06,01,00 06,01,00 06,01,00 06,01,00 06,01,00 06,01,00 06,01,00 06,01,00 06,01,00 06,01,00 06,01,00 06,01,00 06,01,00