6,1,0 6,1,0 6,1,0 6,1,0 6,1,0 6,1,0 6,1,0 6,1,0 6,1,0 6,1,0 6,1,0 6,1,0 6,1,0 6,1,0 6,1,0 6,1,0 6,1,0 6,1,0 6,1,0 6,1,0 6,1,0 6,1,0 6,1,0 6,1,0 6,1,0 6,1,0 6,1,0 6,1,0 6,1,0 6,1,0
6,1,0 6,1,0 6,1,0 6,1,0 6,1,0 6,1,0 6,1,0 6,1,0 6,1,0 6,1,0 6,1,0 6,1,0 6,1,0 6,1,0 6,1,0 6,1,0 6,1,0 6,1,0 6,1,0 6,1,0 6,1,0 6,1,0 6,1,0 6,1,0 6,1,0 6,1,0 6,1,0 6,1,0 6,1,0 6,1,0
6,1,0 6,1,0 6,1,0 6,1,0 6,1,0 6,1,0 6,1,0 6,1,0 6,1,0 6,1,0 6,1,0 6,1,0 6,1,0 6,1,0 6,1,0 6,1,0 6,1,0 6,1,0 6,1,0 6,1,0 6,1,0 6,1,0 6,1,0 6,1,0 6,1,0 6,1,0 6,1,0 6,1,0 6,1,0 6,1,0
6,1,0 6,1,0 6,1,0 6,1,0 6,1,0 6,1,0 6,1,0 6,1,0 6,1,0 6,1,0 6,1,0 6,1,0 6,1,0 6,1,0 6,1,0 6,1,0 6,1,0 6,1,0 6,1,0 6,1,0 6,1,0 6,1,0 6,1,0 6,1,0 6,1,0 6,1,0 6,1,0 6,1,0 6,1,0 6,1,0
6,1,0 6,1,0 6,1,0 6,1,0 6,1,0 6,1,0 6,1,0 6,1,0 6,1,0 6,1,0 6,1,0 6,1,0 6,1,0 6,1,0 6,1,0 6,1,0 6,1,0 6,1,0 6,1,0 6,1,0 6,1,0 6,1,0 6,1,0 6,1,0 6,1,0 6,1,0 6,1,0 6,1,0 6,1,0 6,1,0
6,1,0 6,1,0 6,1,0 6,1,0 6,1,0 6,1,0 6,1,0 6,1,0 6,1,0 6,1,0 6,1,0 6,1,0 6,1,0 6,1,0 6,1,0 6,1,0 6,1,0 6,1,0 6,1,0 6,1,0 6,1,0 6,1,0 6,1,0 6,1,0 6,1,0 6,1,0 6,1,0 6,1,0 6,1,0 6,1,0
6,1,0 6,1,0 6,1,0 6,1,0 6,1,0 6,1,0 0,4,1 1,4,1 1,4,1 1,4,1 1,4,1 1,4,1 1,4,1 1,4,1 1,4,1 1,4,1 1,4,1 1,4,1 1,4,1 1,4,1 1,4,1 1,4,1 1,4,1 1,4,1 1,4,1 1,4,1 1,4,1 1,4,1 1,4,1 1,4,2
6,1,0 6,1,0 6,1,0 6,1,0 6,1,0 6,1,0 0,5,1 0,0,1 0,0,1 0,0,1 0,0,1 0,0,1 0,0,1 0,0,1 0,0,1 0,0,1 0,0,1 0,0,1 0,0,1 0,0,1 0,0,1 0,0,1 0,0,1 0,0,1 0,0,1 0,0,1 0,0,1 0,0,1 0,0,1 0,0,2
6,1,0 6,1,0 6,1,0 6,1,0 6,1,0 6,1,0 0,5,1 0,0,1 0,0,1 0,0,1 0,0,1 0,0,1 0,0,1 0,0,1 0,0,1 0,0,1 0,0,1 0,0,1 0,0,1 0,0,1 0,0,1 0,0,1 0,0,1 0,0,1 0,0,1 0,0,1 0,0,1 0,0,1 0,0,1 0,0,2
6,1,0 6,1,0 6,1,0 6,1,0 6,1,0 6,1,0 0,5,1 0,0,1 0,0,1 0,0,1 0,0,1 0,0,1 0,0,1 0,0,1 0,0,1 0,0,1 0,0,1 0,0,1 0,0,1 0,0,1 0,0,1 0,0,1 0,0,1 0,0,1 0,0,1 0,0,1 0,0,1 0,0,1 0,0,1 0,0,2
6,1,0 6,1,0 6,1,0 6,1,0 6,1,0 6,1,0 0,5,1 0,0,1 0,0,1 0,0,1 0,0,1 0,0,1 0,0,1 0,0,1 0,0,1 0,0,1 0,0,1 0,0,1 0,0,1 0,0,1 0,0,1 0,0,1 0,0,1 0,0,1 0,0,1 0,0,1 0,0,1 0,0,1 0,0,1 0,0,2
6,1,0 6,1,0 6,1,0 6,1,0 6,1,0 6,1,0 0,5,1 0,0,1 0,0,1 0,0,1 0,0,1 0,0,1 0,0,1 0,0,1 0,0,1 0,0,1 0,0,1 0,0,1 0,0,1 0,0,1 0,0,1 0,0,1 0,0,1 0,0,1 0,0,1 0,0,1 0,0,1 0,0,1 0,0,1 0,0,2
6,1,0 6,1,0 6,1,0 6,1,0 6,1,0 6,1,0 0,5,1 0,0,1 0,0,1 0,0,1 0,0,1 0,0,1 0,0,1 0,0,1 0,0,1 0,0,1 0,0,1 0,0,1 0,0,1 0,0,1 0,0,1 0,0,1 0,0,1 0,0,1 0,0,1 0,0,1 0,0,1 0,0,1 0,0,1 0,0,2
6,1,0 6,1,0 6,1,0 6,1,0 6,1,0 6,1,0 0,5,1 0,0,1 0,0,1 0,0,1 0,0,1 0,0,1 0,0,1 0,0,1 0,0,1 0,0,1 0,0,1 0,0,1 0,0,1 0,0,1 0,0,1 0,0,1 0,0,1 0,0,1 0,0,1 0,0,1 0,0,1 0,0,1 0,0,1 0,0,2
6,1,0 6,1,0 6,1,0 6,1,0 6,1,0 6,1,0 0,5,1 0,0,1 0,0,1 0,0,1 0,0,1 0,0,1 0,0,1 0,0,1 0,0,1 0,0,1 0,0,1 0,0,1 0,0,1 0,0,1 0,0,1 0,0,1 0,0,1 0,0,1 0,0,1 0,0,1 0,0,1 0,0,1 0,0,1 0,0,2
6,1,0 6,1,0 6,1,0 6,1,0 6,1,0 6,1,0 0,5,1 0,0,1 0,0,1 0,0,1 0,0,1 0,0,1 0,0,1 0,0,1 0,0,1 0,0,1 0,0,1 0,0,1 0,0,1 0,0,1 0,0,1 0,0,1 0,0,1 0,0,1 0,0,1 0,0,1 0,0,1 0,0,1 0,0,1 0,0,2
6,1,0 6,1,0 6,1,0 6,1,0 6,1,0 6,1,0 0,5,1 0,0,1 0,0,1 0,0,1 0,0,1 0,0,1 0,0,1 0,0,1 0,0,1 0,0,1 0,0,1 0,0,1 0,0,1 0,0,1 0,0,1 0,0,1 0,0,1 0,0,1 0,0,1 0,0,1 0,0,1 0,0,1 0,0,1 0,0,2
6,1,0 6,1,0 6,1,0 6,1,0 6,1,0 6,1,0 0,5,1 0,0,1 0,0,1 0,0,1 0,0,1 0,0,1 0,0,1 0,0,1 0,0,1 0,0,1 0,0,1 0,0,1 0,0,1 0,0,1 0,0,1 0,0,1 0,0,1 0,0,1 0,0,1 0,0,1 0,0,1 0,0,1 0,0,1 0,0,2
6,1,0 6,1,0 6,1,0 6,1,0 6,1,0 6,1,0 0,5,1 0,0,1 0,0,1 0,0,1 0,0,1 0,0,1 0,0,1 0,0,1 0,0,1 0,0,1 0,0,1 0,0,1 0,0,1 0,0,1 0,0,1 0,0,1 0,0,1 0,0,1 0,0,1 0,0,1 0,0,1 0,0,1 0,0,1 0,0,2
6,1,0 6,1,0 6,1,0 6,1,0 6,1,0 6,1,0 0,5,1 0,0,1 0,0,1 0,0,1 0,0,1 0,0,1 0,0,1 0,0,1 0,0,1 0,0,1 0,0,1 0,0,1 0,0,1 0,0,1 0,0,1 0,0,1 0,0,1 0,0,1 0,0,1 0,0,1 0,0,1 0,0,1 0,0,1 0,0,2
6,1,0 6,1,0 6,1,0 6,1,0 6,1,0 6,1,0 0,5,1 0,0,1 0,0,1 0,0,1 0,0,1 0,0,1 0,0,1 0,0,1 0,0,1 0,0,1 0,0,1 0,0,1 0,0,1 0,0,1 0,0,1 0,0,1 0,0,1 0,0,1 0,0,1 0,0,1 0,0,1 0,0,1 0,0,1 0,0,2
6,1,0 6,1,0 6,1,0 6,1,0 6,1,0 6,1,0 0,5,1 0,0,1 0,0,1 0,0,1 0,0,1 0,0,1 0,0,1 0,0,1 0,0,1 0,0,1 0,0,1 0,0,1 0,0,1 0,0,1 0,0,1 0,0,1 0,0,1 0,0,1 0,0,1 0,0,1 0,0,1 0,0,1 0,0,1 0,0,2
6,1,0 6,1,0 6,1,0 6,1,0 6,1,0 6,1,0 0,5,1 0,0,1 0,0,1 0,0,1 0,0,1 0,0,1 0,0,1 0,0,1 0,0,1 0,0,1 0,0,1 0,0,1 0,0,1 0,0,1 0,0,1 0,0,1 0,0,1 0,0,1 0,0,1 0,0,1 0,0,1 0,0,1 0,0,1 0,0,2
6,1,0 6,1,0 6,1,0 6,1,0 6,1,0 6,1,0 0,5,1 0,0,1 0,0,1 0,0,1 0,0,1 0,0,1 0,0,1 0,0,1 0,0,1 0,0,1 0,0,1 0,0,1 0,0,1 0,0,1 0,0,1 0,0,1 0,0,1 0,0,1 0,0,1 0,0,1 0,0,1 0,0,1 0,0,1 0,0,2
6,1,0 6,1,0 6,1,0 6,1,0 6,1,0 6,1,0 0,5,1 0,0,1 0,0,1 0,0,1 0,0,1 0,0,1 0,0,1 0,0,1 0,0,1 0,0,1 0,0,1 0,0,1 0,0,1 0,0,1 0,0,1 0,0,1 0,0,1 0,0,1 0,0,1 0,0,1 0,0,1 0,0,1 0,0,1 0,0,2
6,1,0 6,1,0 6,1,0 6,1,0 6,1,0 6,1,0 0,5,1 0,0,1 0,0,1 0,0,1 0,0,1 0,0,1 0,0,1 0,0,1 0,0,1 0,0,1 0,0,1 0,0,1 0,1,1 1,1,1 1,1,1 1,1,1 1,1,1 1,1,1 1,1,1 1,1,1 1,1,1 1,1,1 1,1,1 1,1,2
6,1,0 6,1,0 6,1,0 6,1,0 6,1,0 6,1,0 0,5,1 0,0,1 0,0,1 0,0,1 0,0,1 0,0,1 0,0,1 0,0,1 0,0,1 0,0,1 0,0,1 0,0,1 0,2,1 3,1,1 4,1,1 4,1,1 4,1,1 4,1,1 4,1,1 4,1,1 4,1,1 4,1,1 4,1,1 4,1,2
6,1,0 6,1,0 6,1,0 6,1,0 6,1,0 6,1,0 0,5,1 0,0,1 0,0,1 0,0,1 0,0,1 0,0,1 0,0,1 0,0,1 0,0,1 0,0,1 0,0,1 0,0,1 0,2,1 3,2,1 6,2,0 6,2,0 6,2,0 6,2,0 6,2,0 6,2,0 6,2,0 6,2,0 6,2,0 6,2,0
6,1,0 6,1,0 6,1,0 6,1,0 6,1,0 6,1,0 0,5,1 0,0,1 0,0,1 0,0,1 0,0,1 0,0,1 0,0,1 0,0,1 0,0,1 0,0,1 0,0,1 0,0,1 0,2,1 3,2,1 6,2,0 6,2,0 6,2,0 6,2,0 6,2,0 6,2,0 6,2,0 6,2,0 6,2,0 6,2,0
6,1,0 6,1,0 6,1,0 6,1,0 6,1,0 6,1,0 0,5,1 0,0,1 0,0,1 0,0,1 0,0,1 0,0,1 0,0,1 0,0,1 0,0,1 0,0,1 0,0,1 0,0,1 0,2,1 3,2,1 6,2,0 6,2,0 6,2,0 6,2,0 6,2,0 6,2,0 6,2,0 6,2,0 6,2,0 6,2,0