6,1,0 6,1,0 6,1,0 6,1,0 6,1,0 6,1,0 6,1,0 6,1,0 6,1,0 6,1,0 6,1,0 6,1,0 6,1,0 6,1,0 6,1,0 6,1,0 6,1,0 6,1,0 6,1,0 6,1,0 6,1,0 6,1,0 6,1,0 6,1,0 6,1,0 6,1,0 6,1,0 6,1,0 6,1,0 6,1,0
6,1,0 6,1,0 6,1,0 6,1,0 6,1,0 6,1,0 6,1,0 6,1,0 6,1,0 6,1,0 6,1,0 6,1,0 6,1,0 6,1,0 6,1,0 6,1,0 6,1,0 6,1,0 6,1,0 6,1,0 6,1,0 6,1,0 6,1,0 6,1,0 6,1,0 6,1,0 6,1,0 6,1,0 6,1,0 6,1,0
6,1,0 6,1,0 6,1,0 6,1,0 6,1,0 6,1,0 6,1,0 6,1,0 6,1,0 6,1,0 6,1,0 6,1,0 6,1,0 6,1,0 6,1,0 6,1,0 6,1,0 6,1,0 6,1,0 6,1,0 6,1,0 6,1,0 6,1,0 6,1,0 6,1,0 6,1,0 6,1,0 6,1,0 6,1,0 6,1,0
6,1,0 6,1,0 6,1,0 6,1,0 6,1,0 6,1,0 6,1,0 6,1,0 6,1,0 6,1,0 6,1,0 6,1,0 6,1,0 6,1,0 6,1,0 6,1,0 6,1,0 6,1,0 6,1,0 6,1,0 6,1,0 6,1,0 6,1,0 6,1,0 6,1,0 6,1,0 6,1,0 6,1,0 6,1,0 6,1,0
6,1,0 6,1,0 6,1,0 6,1,0 6,1,0 6,1,0 6,1,0 6,1,0 6,1,0 6,1,0 6,1,0 6,1,0 6,1,0 6,1,0 6,1,0 6,1,0 6,1,0 6,1,0 6,1,0 6,1,0 6,1,0 6,1,0 6,1,0 6,1,0 6,1,0 6,1,0 6,1,0 6,1,0 6,1,0 6,1,0
6,1,0 6,1,0 6,1,0 6,1,0 6,1,0 6,1,0 6,1,0 6,1,0 6,1,0 6,1,0 6,1,0 6,1,0 6,1,0 6,1,0 6,1,0 6,1,0 6,1,0 6,1,0 6,1,0 6,1,0 6,1,0 6,1,0 6,1,0 6,1,0 6,1,0 6,1,0 6,1,0 6,1,0 6,1,0 6,1,0
1,4,3 1,4,1 1,4,1 1,4,1 1,4,1 1,4,1 1,4,1 1,4,1 1,4,1 1,4,1 1,4,1 1,4,1 1,4,1 1,4,1 1,4,1 1,4,1 1,4,1 1,4,1 1,4,1 1,4,1 1,4,1 1,4,1 1,4,1 2,4,1 6,1,0 6,1,0 6,1,0 6,1,0 6,1,0 6,1,0
0,0,3 0,0,1 0,0,1 0,0,1 0,0,1 0,0,1 0,0,1 0,0,1 0,0,1 0,0,1 0,0,1 0,0,1 0,0,1 0,0,1 0,0,1 0,0,1 0,0,1 0,0,1 0,0,1 0,0,1 0,0,1 0,0,1 0,0,1 2,5,1 6,1,0 6,1,0 6,1,0 6,1,0 6,1,0 6,1,0
0,0,3 0,0,1 0,0,1 0,0,1 0,0,1 0,0,1 0,0,1 0,0,1 0,0,1 0,0,1 0,0,1 0,0,1 0,0,1 0,0,1 0,0,1 0,0,1 0,0,1 0,0,1 0,0,1 0,0,1 0,0,1 0,0,1 0,0,1 2,5,1 6,1,0 6,1,0 6,1,0 6,1,0 6,1,0 6,1,0
0,0,3 0,0,1 0,0,1 0,0,1 0,0,1 0,0,1 0,0,1 0,0,1 0,0,1 0,0,1 0,0,1 0,0,1 0,0,1 0,0,1 0,0,1 0,0,1 0,0,1 0,0,1 0,0,1 0,0,1 0,0,1 0,0,1 0,0,1 2,5,1 6,1,0 6,1,0 6,1,0 6,1,0 6,1,0 6,1,0
0,0,3 0,0,1 0,0,1 0,0,1 0,0,1 0,0,1 0,0,1 0,0,1 0,0,1 0,0,1 0,0,1 0,0,1 0,0,1 0,0,1 0,0,1 0,0,1 0,0,1 0,0,1 0,0,1 0,0,1 0,0,1 0,0,1 0,0,1 2,5,1 6,1,0 6,1,0 6,1,0 6,1,0 6,1,0 6,1,0
0,0,3 0,0,1 0,0,1 0,0,1 0,0,1 0,0,1 0,0,1 0,0,1 0,0,1 0,0,1 0,0,1 0,0,1 0,0,1 0,0,1 0,0,1 0,0,1 0,0,1 0,0,1 0,0,1 0,0,1 0,0,1 0,0,1 0,0,1 2,5,1 6,1,0 6,1,0 6,1,0 6,1,0 6,1,0 6,1,0
0,0,3 0,0,1 0,0,1 0,0,1 0,0,1 0,0,1 0,0,1 0,0,1 0,0,1 0,0,1 0,0,1 0,0,1 0,0,1 0,0,1 0,0,1 0,0,1 0,0,1 0,0,1 0,0,1 0,0,1 0,0,1 0,0,1 0,0,1 2,5,1 6,1,0 6,1,0 6,1,0 6,1,0 6,1,0 6,1,0
0,0,3 0,0,1 0,0,1 0,0,1 0,0,1 0,0,1 0,0,1 0,0,1 0,0,1 0,0,1 0,0,1 0,0,1 0,0,1 0,0,1 0,0,1 0,0,1 0,0,1 0,0,1 0,0,1 0,0,1 0,0,1 0,0,1 0,0,1 2,5,1 6,1,0 6,1,0 6,1,0 6,1,0 6,1,0 6,1,0
0,0,3 0,0,1 0,0,1 0,0,1 0,0,1 0,0,1 0,0,1 0,0,1 0,0,1 0,0,1 0,0,1 0,0,1 0,0,1 0,0,1 0,0,1 0,0,1 0,0,1 0,0,1 0,0,1 0,0,1 0,0,1 0,0,1 0,0,1 2,5,1 6,1,0 6,1,0 6,1,0 6,1,0 6,1,0 6,1,0
0,0,3 0,0,1 0,0,1 0,0,1 0,0,1 0,0,1 0,0,1 0,0,1 0,0,1 0,0,1 0,0,1 0,0,1 0,0,1 0,0,1 0,0,1 0,0,1 0,0,1 0,0,1 0,0,1 0,0,1 0,0,1 0,0,1 0,0,1 2,5,1 6,1,0 6,1,0 6,1,0 6,1,0 6,1,0 6,1,0
0,0,3 0,0,1 0,0,1 0,0,1 0,0,1 0,0,1 0,0,1 0,0,1 0,0,1 0,0,1 0,0,1 0,0,1 0,0,1 0,0,1 0,0,1 0,0,1 0,0,1 0,0,1 0,0,1 0,0,1 0,0,1 0,0,1 0,0,1 2,5,1 6,1,0 6,1,0 6,1,0 6,1,0 6,1,0 6,1,0
0,0,3 0,0,1 0,0,1 0,0,1 0,0,1 0,0,1 0,0,1 0,0,1 0,0,1 0,0,1 0,0,1 0,0,1 0,0,1 0,0,1 0,0,1 0,0,1 0,0,1 0,0,1 0,0,1 0,0,1 0,0,1 0,0,1 0,0,1 2,5,1 6,1,0 6,1,0 6,1,0 6,1,0 6,1,0 6,1,0
0,0,3 0,0,1 0,0,1 0,0,1 0,0,1 0,0,1 0,0,1 0,0,1 0,0,1 0,0,1 0,0,1 0,0,1 0,0,1 0,0,1 0,0,1 0,0,1 0,0,1 0,0,1 0,0,1 0,0,1 0,0,1 0,0,1 0,0,1 2,5,1 6,1,0 6,1,0 6,1,0 6,1,0 6,1,0 6,1,0
0,0,3 0,0,1 0,0,1 0,0,1 0,0,1 0,0,1 0,0,1 0,0,1 0,0,1 0,0,1 0,0,1 0,0,1 0,0,1 0,0,1 0,0,1 0,0,1 0,0,1 0,0,1 0,0,1 0,0,1 0,0,1 0,0,1 0,0,1 2,5,1 6,1,0 6,1,0 6,1,0 6,1,0 6,1,0 6,1,0
0,0,3 0,0,1 0,0,1 0,0,1 0,0,1 0,0,1 0,0,1 0,0,1 0,0,1 0,0,1 0,0,1 0,0,1 0,0,1 0,0,1 0,0,1 0,0,1 0,0,1 0,0,1 0,0,1 0,0,1 0,0,1 0,0,1 0,0,1 2,5,1 6,1,0 6,1,0 6,1,0 6,1,0 6,1,0 6,1,0
0,0,3 0,0,1 0,0,1 0,0,1 0,0,1 0,0,1 0,0,1 0,0,1 0,0,1 0,0,1 0,0,1 0,0,1 0,0,1 0,0,1 0,0,1 0,0,1 0,0,1 0,0,1 0,0,1 0,0,1 0,0,1 0,0,1 0,0,1 2,5,1 6,1,0 6,1,0 6,1,0 6,1,0 6,1,0 6,1,0
0,0,3 0,0,1 0,0,1 0,0,1 0,0,1 0,0,1 0,0,1 0,0,1 0,0,1 0,0,1 0,0,1 0,0,1 0,0,1 0,0,1 0,0,1 0,0,1 0,0,1 0,0,1 0,0,1 0,0,1 0,0,1 0,0,1 0,0,1 2,5,1 6,1,0 6,1,0 6,1,0 6,1,0 6,1,0 6,1,0
0,0,3 0,0,1 0,0,1 0,0,1 0,0,1 0,0,1 0,0,1 0,0,1 0,0,1 0,0,1 0,0,1 0,0,1 0,0,1 0,0,1 0,0,1 0,0,1 0,0,1 0,0,1 0,0,1 0,0,1 0,0,1 0,0,1 0,0,1 2,5,1 6,1,0 6,1,0 6,1,0 6,1,0 6,1,0 6,1,0
0,0,3 0,0,1 0,0,1 0,0,1 0,0,1 0,0,1 0,0,1 0,0,1 0,0,1 0,0,1 0,0,1 0,0,1 0,0,1 0,0,1 0,0,1 0,0,1 0,0,1 0,0,1 0,0,1 0,0,1 0,0,1 0,0,1 0,0,1 2,5,1 6,1,0 6,1,0 6,1,0 6,1,0 6,1,0 6,1,0
1,1,3 1,1,1 1,1,1 1,1,1 1,1,1 1,1,1 1,1,1 1,1,1 1,1,1 1,1,1 1,1,1 2,1,1 0,0,1 0,0,1 0,0,1 0,0,1 0,0,1 0,0,1 0,0,1 0,0,1 0,0,1 0,0,1 0,0,1 2,5,1 6,1,0 6,1,0 6,1,0 6,1,0 6,1,0 6,1,0
4,1,3 4,1,1 4,1,1 4,1,1 4,1,1 4,1,1 4,1,1 4,1,1 4,1,1 4,1,1 5,1,1 2,2,1 0,0,1 0,0,1 0,0,1 0,0,1 0,0,1 0,0,1 0,0,1 0,0,1 0,0,1 0,0,1 0,0,1 2,5,1 6,1,0 6,1,0 6,1,0 6,1,0 6,1,0 6,1,0
6,2,0 6,2,0 6,2,0 6,2,0 6,2,0 6,2,0 6,2,0 6,2,0 6,2,0 6,2,0 5,2,1 2,2,1 0,0,1 0,0,1 0,0,1 0,0,1 0,0,1 0,0,1 0,0,1 0,0,1 0,0,1 0,0,1 0,0,1 2,5,1 6,1,0 6,1,0 6,1,0 6,1,0 6,1,0 6,1,0
6,2,0 6,2,0 6,2,0 6,2,0 6,2,0 6,2,0 6,2,0 6,2,0 6,2,0 6,2,0 5,2,1 2,2,1 0,0,1 0,0,1 0,0,1 0,0,1 0,0,1 0,0,1 0,0,1 0,0,1 0,0,1 0,0,1 0,0,1 2,5,1 6,1,0 6,1,0 6,1,0 6,1,0 6,1,0 6,1,0
6,2,0 6,2,0 6,2,0 6,2,0 6,2,0 6,2,0 6,2,0 6,2,0 6,2,0 6,2,0 5,2,1 2,2,1 0,0,1 0,0,1 0,0,1 0,0,1 0,0,1 0,0,1 0,0,1 0,0,1 0,0,1 0,0,1 0,0,1 2,5,1 6,1,0 6,1,0 6,1,0 6,1,0 6,1,0 6,1,0